################################################################################################################################
###...#.#.####.....#.#..#.#.#.#....#.######.###############.#####.#.#.###.........#.#.#.####.#.#.#.#######.#.###################
#.........#..........#...............#........############...#..#.....#.................#..........#.#####...######.....########
##.........#....................................######.##............................................#........####...###########
#................................................#####.................................................###...#####......########
#................................................#####........................................................#####...##.#######
#...................................................#.#...................................................#.######.........#####
#.........................................................................................................#.#####.##........####
###........................................................................................................#####.............###
##...........................................................................................................#.#...........#####
##...........................................................................................................#...............###
#.................................................................................#.........................................####
#..............................#................................#..................#........................................####
#...........................#.##................................##..............#.#..........................................###
#.................#.......#.#####.............................#.###..............#.#.........................................###
#................##.#......#####...............................#####.................................#......................####
#..................#........#.#.#................................##................................#..#....................#####
##...............................#......................#........###......##.#....................#.##.......................###
#......................................................#..........#.#.......###......................#......................####
###.....................................................##..............#.####................................................##
##...............##....................................####............######................................................###
##.................##...................................##..............###....................................................#
##................####..............................#.######............####..................................................##
##.................##................................############.......###...................................................##
#.................####.............................##############............................................................###
#.................###...............................##..#.#..#.###.........................................................#####
#................#####..#.#........................####........###................##.#....................................######
###.#............#########.........................####..........#..................###.....................................####
#####.............########.........................###...............................###..#.................................####
#####...............####.#..........................####........##....................#.####...............................#####
##.#.#.............#...............................####..........##.....................###.................................####
##.............................S....................##..........###...........................................................##
#...............#................................................###......##.##..............................................###
##...........#.#................................................####.....####..................................................#
#.............#.#.......................##.#....................######....###.#...............................................##
##........................................#..#....................####...#####.................................................#
#...........................................#....................#######.###.............................................#.#.###
##..........................#...............####..................##########..............................................######
###........................#..#..............####.#................#.#####................###...........................#.######
###......................#.###..............######................#....................########..........................#######
###......................###.#...............####.#...............#...................##########..........................#..###
###.....................####..................##...................#...................###.#.##.#...........................####
###...........##.........#....................#...............#..#.#...................#.....#...............................###
####.........#............##.........##.......................##..#....................##....................................###
###...........###.#.................#........................##.##...........................................................###
####..........######.................###....................................................................................####
##.#..........#.#.#.................#........................................................................................###
##.#.................................#......................................................................................####
##...........................................................................................................#.............#.###
##..........................................................................................................#####..........#.#.#
##..................#.#.#....................................................................................#####.........#...#
#....................#####...................................................................................####.............##
##................#.#######.................................................................................#.#####............#
#.........#...##.#..######....................................................................................#.#.............##
##........#.##############..........................#..........................................................................#
#..........############..##.......................#.##..................#.#...................................................##
###..........#########..#..........................#..#.................####...................................................#
###.........######.#.#.#...........#..............#.#.............#.#.#.###...................................................##
###...........#.#.................#...............................##.#.#.#.....................................................#
###...........#...................#...............................##..........................................................##
##................................#............................................................................................#
#.............................................................................................................................##
##.............................................................................................................................#
#.............................................................................................................................##
##.............................................................................................................................#
#.......................................#............................................#........................................##
##.....................................#.................##.........................####.......................................#
##.....................................##..................#.........................######.#.................................##
#...........................................................#..........#####...........#...#...................................#
##.........................................................#..........######..............#................#..................##
#......................................................................######.............................#.##.................#
##................................................................#....######.................................................##
#................................................................#.#...#.##........#..........................................##
##..............................................................#..........#.......#.#................#......................###
#........................................................................##........#.##..............#........................##
#...............................................................#.................#.#..#............#.......................####
##............................................#.................#..........................................................#####
#...........................................#.#.................##.........................................................#####
###..........................................##................#............................................................####
#...........................................#...................##......#.............................................#.....####
##.......................................................................#..........................................##......####
#...............................................................#......##............................................##.......##
##........#....................................................#..#.#...............................................#........###
#.........#.#...............................#.#.................########............................#..#......................##
#..........#.................................##.................#####..............................#.###.......................#
#...........................................###.#................#.#.##..............................#.#......................##
##...........................................###...............................................................................#
#...........................................###...............................................................................##
##............................................#................................................................................#
##............................................................................................................................##
##.............................................................................................................................#
###...........................#...............................................................................................##
###..........................#..................................................................................#..............#
###.#.............##.#........##..............................................................................###.............##
##.#................#........####..............................................................................................#
##...............#######......##..............................................................................................##
###.............#######.....#####..............................................................................................#
####.............#######.......#.............#.#..............................................................................##
#####...........######..........#.............###..............................................................................#
####.............#.#..#.....................####..#............................................................................#
######....##.................................#####.............#.....#.........................................................#
#####...#.#..................................###..............####.###........................................#................#
######.####.#.................................##...............#.####........................................#.................#
############.................................####................#.#..........................................#..............###
###########..................................###...................#........................................###...............##
#####..#.#..................................#..............................................................#####....#........###
######......................................................................................................###..###..#.......##
#####.......................................................................................................###########.......##
####...............................................................#........#..............................#.###########......##
#####.............................................................#.##.#.#####...............##..............##########.......##
####..............................................................#.#########..................#..............##########.....###
#####.............................................................#.#####.#.#................#.#..............#########.......##
##.#...........#....................................................##......#...............##.................#####.#........##
##..............#..................................................#.##......####.##.......#####..............##.#............##
#..............#..............................................................#######.....####.................#.#.............#
##............###..................#..........................................########.##.####.#...............#..............##
#...........#..###................#...........................................########..#.#####..............................###
##.........#.######....#..........##..........................................#########.#..#.#......................#.........##
#............#.#.#.#.##.........................#...#........................###########.........................####.......####
##.............................................#######........................#.#######............................#####.....###
#...............................................###.#............................#####............................#.###.....####
#..............................................####.............................######....E.........................###......###
#...............................................##............................#.#######..............#...............#.#.......#
##..............................................#.................#........#.###########..............#..............#........##
#...................................##.........#................#..#.....#.############.............##...............###.......#
##.....#...........#.#.#.........######.....#...................###......################....#......####...........####......###
###.#.#..#.....#.#.#####.#.....#..#####.#.#.##.#.#........#...######.#.###################.#.####.######....#..#.#.######....###
################################################################################################################################
