################################################################################################################################
######.......................................................................................................................###
######...............######........########..........................###########.##############..........#####...............###
######................#####........########............................#######.....#####..#####..........####................###
#######.................#..........######....S...........................###......####......###...........#..................###
##.####............................#######.........................................###......###..........##...................##
##...###...........................######.........................................###........###.........#....................##
#....###................................#..........................#...............##.........##.........#....................##
##....##..........................................................####........................###..............................#
#............................................................##....##..........................##.............................##
##...........................................................#...............................................................###
##................##.....................................#...................................................................###
##...............####........................#...........#...................................................................###
#................###........................####.........#.................................#..............................##.###
##.............######.......................####..........................................###.............................##.###
#..............######........................###.........................................####...........................####.###
##...........########.......###...............#...........................................###..........................####..###
#............########.......###............................#..............................###...........................##....##
##..........########........####..........................####.............................#.............................#...###
##..........########........####..........................####.............................................................#.###
##.........########..........####..........................##..............................................................#.###
##.........###.#.#..........####............................##.........................##..................................#.###
##.........#.................####...........................##..........................#....###......................#......###
###.......##..................###............................#...............................###....................####.....###
###.......#................................................###..............................#####...................###......###
####......##...............................................##.............................#.####....................###......###
###......##..............................................###..............................#####......................#.......###
###.......##....................................#........###...............................###...............................###
##.......###......................###..........###.......#.................................###............###................###
##......####......................#####........####......#..................................#.............##.................###
##......####......................#.####.......###..........................................##..........#####................###
##......##...............##..........###........##...........................................##.........####..............##.###
##.......................####................................................................##........######...........####.###
##.........................#.....................................##...........................#........####...........######.###
###.............................................................####....................................#............#######.###
##................................................................#..................................................#######..##
##...............................................................#....................................................######...#
#........................................................###..................................##.......................####....#
##.....................................................#####..................................#..........................#.....#
#.................................................##########...................................................................#
##..........##....................................#########.......................................##...........................#
#..........###....................................####.#..#...#..................................##............................#
##.................................................#........###.................................###............................#
#...............................................................................................##.............................#
#..............................................................................................###.............................#
#..............................................................................................###.............................#
#.................................................................................#...........####.............................#
#...............................................................................####..........#####...........................##
#..............................................................................#####..........#####...........................##
#...............................................................................###..........######.....##...........###.....###
#.............................................................................................###.#...####...........####.E..###
#............................................................................................###......#####..........####....###
#............................................................................................#.......######..........####....###
#..........................................................................................###.......######...........##......##
##...............................................##...................................................######..................##
##............................................######..................................................####....................##
###......................#................#########....................................................###.......#............##
###.....................###.............#########..........#...........................................##........###..........##
###.....................###...........##########..........###....................................................####........###
##.....................####.......#.###########............##....................................................####........###
#......................##.......##############.............###.....................................................###.......###
##...................#####.....#############................##.....................................................###.......###
#...................######.....###########..................##...................#..................................###.......##
##.................#########.########.###......................................#####.#.####.........................##........##
##..................###############...........................................#############..........................#.........#
###.................#########.######.........................................##############....................................#
###..................######.....#####..........................................###########....................................##
##....................#####.......####...........................................###..........................................##
##......................##........#####.........#............................................................................###
##.................................####........###...........................................................................###
##.................................###........#####........####..............................................................###
##..........#.................................####.........######..............................................................#
##..........###..............................#####.........######............................#.................................#
##..........###..............................####............####...........................###................................#
##...........#...............................####..........................................#####...............................#
##...........................................###.................................###.........###...............................#
##....###....................................####................................####........####..............................#
##.....#......................................####................................##..........###............................###
##.............................................##..............................................###...........................###
####.....##......................................#..............................................###.......................##.###
####.....###.....................................................................................###.....................###.###
####.....###...............#..................................###.................................####....................##.###
####......................###................................######................................####..................###.###
###.......................####....................##..........######.................................##...................#...##
###.......................####.....................#.............##.................#........................#............#...##
##.........................####...................###..............................###.....................#####...............#
###........................####....................##..............................###....................########............##
##...........................###.................####...............................###....................#########...........#
###.........................###.................####.................................##...................##########..........##
##...........................##................#####......................................................#####...............##
####........................###...............#####.......................................................####...............###
####........................##.................###...........##............................................####..............###
#####.......................#..................#..............##.............................................###..............##
#####.................................##.......................#...............................................#..............##
#####.................................#..............##........................................................................#
#######..............................................#.........................................................................#
###########..........................##........................................................................................#
################.....................#..........##...........................................#.................................#
####.############........###...................###...............#..........................###................................#
##...#############.......#####.................###.............####.........................##.........###....................##
##....###....#####......######.................##.............######..................................######..................##
##...###.......###......#######...............##................####...................................#######................##
##....##.......##......########...............#.................####.........................................######............#
##....##...............########..............##...................#..........................................#######..........##
##......................####.................##...............................................................######...........#
##.......................#..................###...............................................................####............##
#.........####.......................###....###................................................................#...............#
#.......####..........................##..#####...............................................................................##
#........###..........................##########.....................................................##...............#####...##
#........#.............................##########...................................................####.............#######.###
#......................................####.#.###...................................................####.............#######.###
#.......................................###...####.........................###........................#..............#######.###
#...........................###.................#..........................####.....................................########.###
#.........................####............................................####.......................................#######.###
#.......................######............................................................................................##.###
##.......................#####..........................................##...................................................###
##........................####.........................................###...................................................###
###.........................###..................................########....................................................###
##..............................................................#########..................................................#.###
##.............................................................#########..................................................##.###
#...............................................................########.........................................####.#.####.###
#...............................................................#######.........................................############.###
#........................................##......................######.........................................##########.....#
#........................................####...................########.......................................########.......##
#........................................####.........#........##########.............................#.........#####.........##
##......#..#.#.#.#.#.#.#.#..............#######.#.#.#####.....############.#...........#............#####.....########.......###
############################........#.#.###################..##################.#.#.######..........#####.#.#.#########.#.#.####
################################################################################################################################
