################################################################################################################################
##########################################...................................................###################################
######..............#########..##########.......#####..###....##############.....########.....#########################.....####
#####................#######.......#######......................###########..........####......#######################.......###
####........####....................######.........................#########..........###......#########......................##
#####.############...................#####..........................############......####....##########......................##
###################..................................................############.....#################..........####.........##
################.###..........................................##.......##########.....###########..####......#########........##
######..########.###...........###...............###.........####.........########.....##...........####....##########........##
#####....###..##.##...........####..............#####.......#####..........#######..................##################.........#
####...........#.##...........###..............######.......####...........######..................##################..........#
###..............#............###...........#########........###............##.....................##############.............##
##...........................####..#......###########........###..............................#...########..####.............###
##...........................########....######..#####......................................#.##.########....................###
##...................##.....#########....#####....####.....................................##.###########.....................##
###.................####...#########....######.....###.....................####...........###.############.....................#
####................###############....#######.....##....................#########........###.############.....................#
#######............###############.....#######....###...................##########.........##.#############.......##..........##
#######.............##..##########.....######....###.............##.....##########..............############.....####....##..###
#######..................##########...............#.............####.....########...............#############....####...########
######......................#######............................####.........#####..............#####..#######....###....########
###...........##..............................................####...........####.............#####......####...####....########
##...........####.............................................###........##...###.............######......##...######.....######
#....###.....####............................................####.......####...###......##.....########.......########.....#####
#....###.....#####.............................##............####.....######...###......###....##########.....########......####
##..........######............................##..............####...######....###......##......##########.....#######.....#####
###.........#####........................######................###....###......####.............##########......#######..#######
###..........###...........#............######......##..........###.............####............##########...........###########
###.......................###.........#######......###..........####............####............##########............##########
###......................####........#######........##..........#####............###.............###..####............##########
##.......................####........######......................#####...........###...................####...........##########
##......##...#...........#####.......######.......................####..................................####...........#########
##.....########.........#######.......#####.........................##...................................####...........########
##.....########.......##########.......#####..#......................##..................................####................###
##....#########......###########.........#######.....................###..................................##..................##
##.....###..##.......###########..........#####.........#....####...######........................................##..........##
#.....................######...............###.........###..###############......................................####.........##
#.....................#####............................#######..###########......................................#####...##..###
#..............##...................#####...............#####....##########......##...................#..........###############
#.............####.................#######....#...........##......########......####....##...........###.........###############
##............####...##...........#######...####..................#######.......#####...####........####........####......######
###..........####...####...........##......#####...........#.....########.......#####...######.....####....########.........####
###.........#####...####...................####...........###...#########.......####.......###########....#########..........###
###.........#####....##.....................###...........###...##########..................#########.....##########.........###
###..........###............................###............##...############..................#######.....####.#####.........###
###...........#............................#####.................############...................#####......##....####...##..####
###........................................######.................###########....................####......##.....##....########
##.........................................#######......S............#########....................##......####...........#######
##.....##..................................######........................#####...##........##...........######...........#######
##....####.................................###................###.........###...####......#####........#######............######
##....#####..##...........................####...............####...............####......##########..#######................###
###...#########..........................#####..........##....##.................##........##########.####....................##
###....########...........###..........#############...###..................................#########..##............###......##
###....########...........###.........####################.....................................#####................#####....###
###....########...........##..........############...####.......................................................########....####
###....####..###......................###########.....................................##.......................#####........####
####....##....##.......................#########.....................................#######...................####..........###
####.......................###.........########..........................#......#....########..................####..........###
####......................#####........#######..........................###....###...########........###.......####...........##
###........##...........#######.......#######...........................###...###....########........###........####..........##
##.......#####.........###...#.......#######............................###...##.....########.........#.........####..........##
##......#######........##............#####.......##.....................####.###......########...................###.........###
##......#########......##............####........###....................#######.........#######.............................####
##......####..####....###...........#####........####....................###.#...........########..........................#####
#........##....##########.........######.........#####........................................####.........................#####
#..............##########.......######..........#########..........................###.........###.........................#####
#...............####..####.....#####...........###########..........................###........###..........................####
#...............###....###......###...........############...........................##.......####...................##......###
#...............###.....###...................#############..........................#........###...................###.......##
##..............##......###...................######..#####....................................#..................#####.......##
#####..........###.....####...................#####....#####.....................................................####........###
#####..........###....####.....................##.....##.###.....................................................###........####
###.............#.....###.......................................................................................###.........####
##....................##.................................................................###..............##..#####.........####
##....................................................................................#######............##########.........####
##...........................##.......................................................########...........#########..........####
##..........................####.........#................................................######..........##................####
###..............####.......#####.......###................................................#######...........................###
#####...........######......#######.....###..........................................##......######..............###.........###
#########........#####.....#########.....#...........................................##.......#####....##.......#####.........##
##########.........###.....#########..........................#......................##.......#####...####.....######..........#
##########.................########..........###......##.#...###.............................######....##......#####.....E.....#
#########..................###...##.........#####......###........##..........................####..............####..........##
#######....................###...##.........#####.................###..#.......................###...............###..........##
######......................#...####........######................#######...........####.......####.....##....................##
######..........................####.......#######................######...........######......####....####...................##
#####...........................####......#######................###...............################....####...##..............##
#####...........................####....########................###.................###############.....##....#..............###
####............................####...########.................##....................############..........................####
###..............................###...####..........##.........##.....................##########...........................####
##................................###...............####.......####...##...............#######...............................###
##.................................#................####......#####..####..............######................................###
##...................................................##.......#####.#####...............#####................................###
##............................................................####...###................####................................####
##.............................................###............###.......................###..............#..................####
##.............................................###............###......................####.............###.................####
##.............................................###............###......................####...........#####.................####
###...##......................................####............####......................##........##########.................###
########................................##########............####...............................############................###
########................................#########.............####...............................#############................##
########......###.....#.................#########..............###......#.....#..................######.######................##
########.......###...###....##...........#########.............###.....###...###............##....###....#####.................#
########.......########....####..........###########...........####....###...##.........#..####...........#....................#
###..##.........#######...#####..........############..........#####...##...##..........#######...........####.................#
##..............#######..#####............#####...##..........######.......###...........######...........####.................#
##...............#####...####..............####..........##...######......####............####.............##.....##...........#
##...............####.....##..............................#....####.......####......##....####...................###......#....#
###.............####.......................................................###.....####..#####..................###......###..##
###...###.......####..............................................................###########......###.........###.......###..##
###...####.......##..............##...............................................##########.......###........####.......###..##
##....#####......................###...............####..........................#####..##.........###........####.......###..##
#......######.............##.....#####............######.........................####..........................##.........##..##
#.......######...........###.....######...........#######.......................#####..........................................#
#........#####............##.....#######.......#...#######.......###...........######................##........................#
#.........###.....................######......###......###....#######..........######..............####........................#
#..................##..............#..........###.......##...#########..........####...............####.......................##
#.................####........................###.......##...#########.......................................................###
##...............#####........................####...........#########...............................................##......###
##...............######........................###............#######................................................###.....###
#...........##....######........................##............######.................................................###......##
#..........####...#######............#####....................######..........................................................##
##........###############...........########..........##......######....................##....................................##
##........###############...####...###########.......####.....#####....................####...................................##
#.........############.....#####################....#####......####............#####..#####...................................##
##..###..############......######################..#####.......####..........###############...####......###....####..###.....##
####################......###############################.....########......#################################..###########...###
#####################..#########################################################################################################
################################################################################################################################
