################################################################################################################################
####.#......#.###########.#.#.####.#....#.#..#.#.#.############################################.....#########.#.#........#######
###.............#######.......##......................##.#.########..............#.#.##.#.###........########..............#####
##................#####.........S..........................###...##.......................###.........#####...............######
#...................#.......................................##....#...................................#####................#####
##..............................##........................####........................................####................######
#..............................####......................######........................................##.................######
##..............................####.....................#####............................................................##..##
#...............................#####.....................###.................................................................##
##..............................######.........................................................................................#
#................................#####........................................................................................##
##..............................######........................................................................#................#
#................................####........................................................................###..............##
##..............................####.........................................................................##................#
##...............................##...........................................................................................##
#...............................##.............................................................................................#
#................................##...........................................................................................##
#...............................###.....#......................................................................................#
#................................####.###...................#.................................................................##
#..................................#######.................##..................................................................#
#....................................####..................####.....########...................................................#
##.....................................##.................######......######..............##...................................#
##.........................................................######.....#####...............###..................................#
##........................................................#####........####................###.................................#
##.............................................#..........#####........###..................##.................................#
##............................................##..........####.........###....................................###..............#
##.......................................................#####...............................................####..............#
##.......................................................####..............................................#######.............#
##........................................................####.............................................######.............##
##.......................................................####.............................................###.#.........###..###
##........................................................####............................................###............#######
##........................................................####...........................................###.............#######
#...........................................................#.............................................#...............######
#.........................................................................................................##.................###
#.............................................................................................................................##
#........................................................................................................................#...###
#........................................................................................................................###.###
#.............................................................................................................###........#######
#..........................................................###..............................##...............####.........######
#........................................................####...............................##................#...............##
#......................................................#######.........................##...##.................................#
#.....................................................#######...........................#####..................................#
#.....................................................########...........................####.........###......................#
#.........................................................###.........................................###......................#
##.........................................................##..........................................###.....................#
###............###.............................................................................................................#
####..........#####............................................................................................................#
####..........####..............................#..............................................................................#
######.........#................................#..............................................................................#
######.........................................###............................................................................##
########........................................##...........#.................................................................#
########........................................##..........###................................................................#
#########.............................#.....................####...............................................................#
########.............................##.....................#####.#.#..........................................................#
######......................................................#########..........................................................#
####..................#.....................................########...........................................................#
####.................####....................................#####....................................................##.......#
###.................####.....................................####................................................#######.......#
##..................######....................................###...............................................#######........#
##................#########...................................###...............................................#######........#
#...................########..................................####......#.....................................#######.........##
#..............................................................##.......##....................................#####..........###
#......................................................................###...................................####............###
#......................................................................###...................................####...........####
#.....................................................................####....................................#.............####
#.....................................................................####.................................................#####
#......................................................................###.................................................#####
#....................................................#..................####............................#.................######
#...................................................#####..............................................###................######
#..............................#.....................######.#................#.........................####...............######
#.............................###....................########................##.........................###................#####
#.............................##.......................######................##.........................####................####
#.....................................................######.................#...........................###.................###
#......................................................##....................#...........................###.................###
##...................................................####..................................................##..................#
###..................................................###.................................##................#..................##
#####.#.#...............................##.........#####................................###...................................##
##########............................#####........####..................................###................................####
##########............................####.........####..................................###................................####
######.####..........................##..............#......##............................####..............................####
####...###...........................##.....................###...........................#######............................###
###.....###..............###........##.......................##............................#######...................##........#
###.....###.............####........###............###......................................#######...............######......##
###......##.............##.#........##............######....................................#######...............######......##
##.................................................#######...................................#.#####..............#######...####
##.................................................#######.......................................###................#####...####
##..................................................########.....................................##...................#.#...####
#...................................................########................................................................####
##...................................................###.####.................................................................##
#...................................................####...#..................................................................##
##..................................................###.......................................................................##
##..................................................###.......................................................................##
###................................................#####......................................................................##
###.................................................#####.....................................................................##
####................................................########..................................................................##
####................................................#########..................................................................#
####................................................########..................................................................##
###.................................................########...................................................................#
###.................................................###.#......................................................................#
##..................................................#..........................................................................#
##..........................................................................#..................................................#
##..........................................................................###................................................#
##..........................................................................#.#................................................#
##.............................................................................................................................#
##.............................................................................................................................#
##............................................................................................................................##
##..........................................................................................................................####
#...................................................##....................................................................######
#......................................##..........###...................................................................#######
#.....................................####.........###.................................................................#########
#.....................................##...#......###.................................................................##########
#..........................................##......#...................................................................#########
#..........................................##.....................##.......................................................#####
#..........................................##....................##.......#..................................................###
#...............................................................###......##..................................................###
#..............................................................................................................................#
#.............................................................................................................................##
#.............................................................................................................................##
#.......................................###.........................................................................####.....###
#......................................####........................................................................####.....####
#......................................####........................................................................####.....####
#......................................####...............###......................................#...............##......#####
#......................................#####..............###....................................####...............#......#####
#........#.............................#####..........................###.......................###.###...........#.E.....######
#......#####...........................######........................######.....................###...............##.....#######
##.....#####.................#........#######......#................#########...................##...###........####....########
####.###############.......######.#.###########.#######...........#############........##......#####.###......########.#########
################################################################################################################################
