################################################################################################################################
##########################################.............................................................###############..########
########..#####....####.......###########.........................##########..########......##########.#........####.....#######
#...###....##..................##########.........................#########....######............#####...........##.......######
#....##................#.......##########....###..................#########....#####..............####....................######
##....##..............###......#########....#####...............###########.....####..............####..............##....######
###...........###....####.......######.....#######..........################....####..............####.............#######...###
####..........############.................#######..........################.....##...............####...##.......########....##
####..........#############.................#######...............###########.....................####..####.....#########....##
#####...........############.................#######...............##########......................##...####.....########.....##
######..........############...................#####...............##########............................##......##...........##
########........############....................####................######...........###......#...............................##
#########.....#############.....................#####................####............######..###..............................##
##########...##############...##...............#######...............................######.####..............................##
####...##....#############...####.............#########...............................#####.#####.............................##
###..........############....####............##########................................####.#####.............................##
###...........###............###.............######.##..................................###.##########........................##
###..........................................#####.......................................##.##########........................##
###...###.....................................####............................................########........................##
###...####............##..##..................#####.............#..................##..........#######........................##
##....#####...##......######.................######............###................####..........######........................##
##.....##########.....#####.................#######............####...............####...........#####........................##
##......#########...........................######..............####...............####..........#####.........................#
##......#########...........................######......#####....##........#.......####...........####..............##.........#
##......#########...........................######.....#######............###.....####......###....................####........#
##......##..#####....................##.....#####......#######............###....#####......####...................#####.......#
###...........##....................#############.....#######.............###...######......####....................#####......#
###............................#....############.....#######.............###....#######...#.####.....................######....#
##............................###....###########....########...........#####.....##########.####.......................#####...#
#.........##...........###...####......##...####.....#######..........######......#########.####...........###..........########
#........####..........###########...........##.......##...............####.......#########.####...........####.........########
##.......#####..........##########......................................##.........########.#####..........####........#########
###......#####...........#########................#...................................#####.#.###..........####........#########
###.......####............##...##................#####..........................#......####....#..........######........########
##........###....................................######........................###.....####..............######...............##
#.......#.##.....S................................#####........................#####..#####...............##.........#.........#
#.....###.#........................................####.........................###########.........................##.........#
#.....###..........................................###...........................##########..........................#.........#
#.....##..........................................####...........................##########...................................##
##.......................#.......................####.............................####...##.#...............###..............###
##......................###.....................####...............................##.....#.#..............####.............####
##......................####.....................##.......................................#.##.............####.............####
##.........##............####.............................................................#.####..........####...............###
##.........##.............###.............................................................#.#####........####......##........###
##..........................................................................................######......#####......###......####
##...##.....................................................................................########....#####.........#....#####
###.####........................................#####.......................................#########..#####..........##########
#########.....................................########................................##.....#########.###.............#########
#########...................................###########.........##....................###....#########.##...............########
#########............................###..############.........####...........####.....###....####..##.##................#######
#########............................############.............####............####.....###..........##.##................#######
##...####.....#.........###..........###########...............##......................###..........##.###......##.......#######
##....###....######....#####.........#########....................................................####.####....####.....########
###..........###############.........########....................................................#####.#############....########
###...........###############........#######.....................................................#####.#############...#########
##............################........#####.......................................................####.############....#########
##............#####..#########.......................................................................#.############.....########
##.............###....#######..........................................................................####..#######......######
##.....................##.................................##...###.....................................###....#######.......####
##.....###...............................................##########....................................##......#######.......###
##....#####.............................................##########.............................................#######.......###
##...#######...........................................#######..................................................###..........###
###.########...............##......................##########.................................................................##
###########...............####.........##.........##########..................................................................##
##########.......####.....####........####.........#########.........######...............#..........#.#......................##
######..........#####......###........#####............#####.........#######.............##.........##.####..##......##.......##
#####............####.......###......######............#####.........########............##.#.....####.#########....####......##
#####........................###....#######.............####.............####............##.##########.#########...#####.....###
######........................###...#######.....##......###.............................###.##########.########....#####....####
######........................###....#####......###.....................................###.##########.#####.......#####...#####
#######........................###....###.......####..........##....###.................###.##########.#............###....#####
########..........##............#................###.........####..####.....##...........##.##########......................####
##..#####........##########..................................##########....###..............##########.#.....................###
#....#####.......###########..................................######......####...............#########.#......................##
#.....####........####...###..............................................####................########.#......................##
#......###.........##.....##...............................................####................#######.#......................##
##......###...............###...........................##..................######..............######........##..............##
##......###...............###.....###..................####.................#######..............#####.......####............###
#.......####...............#......######...............####.................#######..............#####.......####............###
#........##.......................########.............####.................#######...............####.......####............###
#....................##..........#############..........####..................######...............##.........##.............###
#...................####.......######..#########........#####..................######.........................................##
#..................####........###......########........######.................##########......................................#
#..............########.................########.........######...............###..########....................................#
##............##########................#######............#####............####....#######............###....................##
##............##########...............#######..............####............###.....#######............#######...............###
##.............###..####...........##########................##.............##.....########............########..............###
###..................###.........##########........................................###..###............#########.............###
###.............................###########.....##................................###....##......#......###########.........####
###.........##...................######..#.....###...............................###.....##.....##............######........####
##..........###...................####........####...............................##......##......#.............#####.........###
#...........####...................###.......####...............................###......##.....................####...###....##
#...........#####..##..............###.......####.............................######.....##......................##...#####...##
#...........##########.............###........####...........................########.................................#####...##
##..........###########...........#####.........###.........................#########.................................######.###
##...........##########...........########.......##..........................#######.....................#####.........#########
###.................##............#########...........................###.....####.......................#####..........########
###................................########.........................#####......###......................................########
##..................................######.............#...........#######......#..###..................................########
##...................................#####............###..........#########......#####.................................########
##...................................######............##...........#########......####.......###.......................########
##................#.................#######............##............####.####......###......#####.E...................#########
##...............###...............########............###.................###......###.....######....................#####..###
#................#########....##..#########.............##.................###......###.....######............############....##
#.................########...##############.................................#.......###.....######...........###########......##
##.................######################............................................##.....#######.......############........##
##.......###........############..######.............................................###..#.########.....#######.............###
##.......###...........########.....####.....##.....................................####..#.########.....######.............####
##......................##...........###....####........................##..........####..#.########....######.............#####
##....................................#.....####........................###........########.########...######..............#####
##...........................................##....##....................#.........########.#######....######...............####
###...###..........................##.............####............................#########.#######.....######...............###
###...####........................#####............####..........................##########..#######.....#####...##...........##
###...####........###.............######...........####..........................#########......####.......##...####....##....##
##....####.......####............#######............###..........................#########.......####...........###########..###
##.....###.......####............#######.............##..........................##########......#####...........###############
##......#.........##.............######..............###........................###...#######...######............##..##########
##................................####......##.......###............###..........#....################.#...............#########
##......................##.........##......####.....................####...............###############.####.............########
##......................###...............######...........###.......####...............##############.#####..............######
##......................##......##........######..........#####......####................###....######..#####.....##.........###
##..............................##.........#####..........#####......####....#...................####....####.....##..........##
##..............................##.........####............####.....####....###....#..............###....#####................##
##.........................................###.....##.............######....####.####.............####....######..###.........##
###......................###..............####.....##............########..##########.............#######....##########......###
####....##...##.........#####............######...####..........#####################............#########...###########..######
##############################..######################################################.......##############..###################
################################################################################################################################
