################################################################################################################################
#################################............................................................................................###
#####.#..#.#.####################....#######......###########.....####..........########....#########.......####.#######.....###
####....................########......######......##########......###............######.......#...............##.#######.....###
###.......................#####........####........#########.....#####...........#####........................##.######......###
###.......................#####.........###........######.#......######...........####...........................#######.....###
###........................###........................#..........######.........######...........................#.#####.....###
##.........................###.....................................#####.......#######..............................######...###
##..........................#......................................######.....#########.........#####..#..............##.....###
##...........#.......................................................####.....##########......#######..##....................###
#...........##.....#........#........................................#####...#######.#.###...########..##....................###
##......#.##########......###.........................................####....#####....##############..#.....................###
#.......############......#####.....................................#####.....###........############........................###
##......###########......######....................................####........###........##########.......###...............###
#.........########........#####..................................######........###..........######.........####...............##
##...........................#...................................#####..........####..........#####.........###...............##
###..............................................................#####...........###...........####..........###..............##
###..............................................................#####............###............####.........##..............##
####..............................................................####..............#............####..#.......#..............##
#####.............................................................####........................................................##
######............................................................####....................................#...................##
######...##.......................................................######..................................###.................##
#######...#.......................................................##.....##...............................#...................##
#######..##.......................................................##...#####..............................#...................##
######....#..............................................................###..........................................#.......##
#####....##.......................................................##.....###.........................................####.....##
###.......#.......................................................##......##................###.......................####...###
###......##..................S....................................##......###...............###.........................###....#
##.......##.......................................................##......###...............###.........................###....#
##......###.......................................................#......######.............###.............#.............#....#
##.....####.......................................................##....#########..........####...........#####...##.....##...##
###...#####............................................................###########......#######...........######.####....##...##
###.#######...........................................................############.....########...........######.####....##..###
###########...........................................................####.#######.....########...........######.###..........##
#######.###..........................................................#####..#######....#####.########..########..............###
#######...............######.........................................###.....######.....###....######..###.##..................#
#####................#######.........................................#.........####...........#######...##.###.................#
#####...............#######....................................................................######....#.###.................#
###.................#######.......#.............................................................###......#.####................#
###.................#######.......##.....................................................................#.####................#
##...................#####........##..........................###........................................#.####................#
##...................####.........##.##.......................###........................................#.#####...............#
##............................#.####.####.............###.#.#####..........................................#####.............###
###..####....................#######.##########.....#############..........................................#####.#...........###
########.....................#######.###########.##.#############..........................#.#.##..........#####.##..........###
########.....................######....######..#.###############..........................#######...........#....##..........###
####.#.#.#....................####.....####......###############........................#######...............................##
####.....###..................###.......###......######.#.#.##..........................#####................................###
##.......###..................###................###..........................#.......######..................................##
##........###.......###......###.................##..........................##.......#####..................................###
#.........##.........####.#.##...................#...........................##......#####....................................##
##.........##........#.######...............................................###.....#####....................................###
#..........##............###...................................#.............##.....#####...........#..##........#...........###
##.........###............#...................................##............###...######...........##..##........#...........###
##.........###..............................................####.............####.######...........##............##...........##
##.........###.......................................#....#.##.....#....#...###########............##............##...........##
##.........###..........................................######....###.#####.###########............##..........#.##............#
##........####........................................######.....####...###############............##..........#.####...##.....#
###.......####.........................................######....##....################............##..........#.####.###......#
####......#####........................................######..####.....###############............##............#########.....#
####......######.......................................###########.....################.............#.............########.....#
####......#######......................................##########.......################...........................######......#
###........#######.....................................#########........################............................#####.....##
##........#######.......................................######...........################..................#........###.......##
##..........#####......................................#######...........############.....................####......###.......##
##......#.#####..........................................###...............#############..................#####....###........##
##......########........................................#####..............############...................######.#.###........##
##....##########........................................####................###########....................#####.#####........##
###..#############.....................................#######....#.........###########...................######.#####........##
#########.#########.#.###.............................########.#.#.#........############...................#####.######......###
######......#############..............................#########............######.######................#######.######.#.#..###
######........#..#########............................###########..........######....#####....###........#######.##########..###
####...............#####...............................#########...........#####....######....####.....#########.##########..###
###...............######..............................##########..........#####......#####......###....###.#.###.##########..###
##.................####...##...........................#######............#####........#.....................###.##########..###
##.............#.######....##........................#########.........#.######................................#.##########...##
##............#########....###...................###########.........#########............E......................#.#.#####...###
###...........########......####...............#.########..........####.######.........................................####...##
####..........#########.....####.............###.#######......##.####......##.......#.......#...........................###..###
####............######......######......########.#######.....######................####.....##...........................###.###
#####..........#######......#####........#####...#######......#####................####....#####.##.....###..............###.###
######..........##..#.......####.........#####....#######.....####...............########..##########..####..............###.###
#####..##......##...........####..........#####.#########......###..............####################...####..............###.###
#########.....#####........###............################.....................#####################...###..............####.###
###....###....#####........####............##########..##......................####################.....................####.###
###...###...#######........###.............##########...##......................#######....#######......................####.###
#.......#...######..........#................#.#####...........................######......######.......................####.###
##.........#######................................#............................####..........###.................##......###.###
#..........#####...........................................................#######............#..................##......###.###
##..........####..........................................................#######...................#..##........##........#.###
###.........##............................................................######...................##..###.....#.##...........##
###.......................................................................#####....................##..####...##.##......#.....#
####........................................................................##.....###............###..#########.##.....####.###
#####......#......##.#.....................................................###.....####...........###..#########.##....#####.###
#####.....##.....#######...................................................###....#####......##.#####...########.#......####.###
######....###...##########.....#...........................................###....#####....####.####....######.#.#......####.###
######....##.....##########.######........................................####....#####...#####.#####....###.....#.......###.###
#####.............##################......##.#.###........................####.....#####.####.....####..###.............####.###
#####................#################...#########..........##...........######....###########....####..###..............###.###
####...........................#######.....#######.........###............#####.....#########.......#..####.............####.###
###..............................####....########............#...........#######....#########...........#####.##..#.#.#.####.###
###.......##.................................#####........................######.....#######............########.###########.###
###.....#####................................####.....#.#......#.........#######....########............########.###########.###
####.....#.##..................................##....############.........######.....#####..............########.###########.###
#####......###........#.............................##############........######...######..............#########.#.#.#######.###
######......#........##..............................#############.........#######.######..............##..####........###...###
#####......###.......###.............................############..........############................#....##.........###....##
#####......##.......###................................##########............#########.................#...............##.....##
####.......##.......###.................................#......................#.#.#................##.#...............###...###
####......###......###.........................................................#....................##.#..............####.#####
###.......###......###............................................................................####.#...............#########
##........####.....##........................................................###...#......#......#####.###....#........#..#.####
##.......#####...............................................................###.#.##.....###...######.########...............##
##.......######..................#.........................................###########.....##.########..######.................#
#......########................####........................................###########.....##########....#####................##
##.....########................###........................................############......########.....###..................##
##.#.#########.............######...............##........................############.......#######.....####............#######
#############.........#.#########....##.......###########...................#.#########......######.....#####..........#########
#######.............###########......###......#########.......................#########.......####.......#########.....#########
#####.............############....######........#.#.####........................#######........###.......########.....##########
#####............##############..#######............####.......................#########.......#..........#######......#########
#####.............#.#.#########.##########............###.......................#######......#.#............#####.....##########
####....................##################..............##......................########....###.............#####......#########
######.#.#..............####################.#.#.................................########.######..............####....##########
#############............#########################..............#.................##############..............#####...##########
###############........############################..........#######.#............################.............#################
#################.#.#.#############################......#.##############.#.......################.#..#.#..#.###################
################################################################################################################################
