################################################################################################################################
#######...............................#####################################################.#.##########.....######.############
#######.########.......###########......###############.#.########......#####...#####............######........#......##########
#######.########........########.........############.....#######.........#.......#..............######..............#####...###
#######.######..........#####...................####......###..#...................................###................#####..###
#######.####..............#.......................#.......#........................................####..............######....#
##.#.#...........................................###................................................##..............########..##
##................................................#..................................................#..............########...#
#................................................##.................................................................#######....#
##....................#..............................................................................................####.....##
#...................####.......................................................................................................#
##.................######.....................................................................................................##
#..................######........................##...............#####.......................................................##
##..................#.#.#........................#..........#....########....................................................###
##.........................................................####..########....................................................###
####.......................................................###.....#######.......................................#..........####
###................................###.....................####.......#.#...................................#######.........####
###...............................######............#.......###.....................................####....#######........#####
##................................########.........###........##...................................#####.....#.###..........####
##...............#...............#########..........###............................................#####.......###..........####
##......##.......##...............########..........###......................................................................###
##....#.##......##................#######............#........................................................................##
##...##.........#.......##.........#####.......................................................................................#
##.............##.......####.......####......................................###...............................................#
##............##.......########......##............S.....####...............#####..............................................#
##......................########....###...................#####.............#####..................#...........................#
###...................######.#####...##....................................######..................#...........................#
####..................####...#####.#.#......................................#####..............................................#
####................######.....#####.......................................######..............................................#
#####...............####.......######..................................#....####...............................................#
####...............#####.......######................................#####.#####...............................................#
####...............####.........#######............................#######.####................................................#
####...............####.........#######...........................########...##................................................#
####................##...........########.....#..................#######.......................................................#
####.............................##########...##.................########......................................................#
####.............................##########.#####...............######.........................................................#
####.............................################............##.#..#..........#................................................#
####............................#################...........######............##...............................................#
###............................#################.............####.............##...............................................#
###............................#####.##########..............####..............................................................#
##....................##......####...#########.................###............................................................##
#......................##.....#####...#######..................####....................................................#.......#
##....................##......####....######....................#####..................................................##.....##
##.............................###.....####...........##.........######.......................................#................#
##..................#..........###.....###...........###........########.....................................####.............##
###...............#####................###...........#####.......######......#.............................#######............##
###.........###########................###...........#########..#.#.........###......................#.#.#.########..........###
###.......################.............###...........##########..............##.....................#########....###.........###
###......##################.............#...........#########................###......##............########.......#.........###
##.......#........#########.........................#########.................##.....###............####.#.#.................###
###.......................#.......................#########..........................####...........####.....#.................#
##................................................#########...........................##.............##......##...............##
####..............................................#######.............................###............####...###...............##
#####.................................................#...............#...............##..............#####...##...............#
#######...............................................##.............###..............###...............##....##...............#
#######..............................................................#####............##....#..................##..............#
#####..................................................##............######..........#########.................##.............##
####.....................................#..............##.............####..........##...###..................##...........####
###............##.......................#####...........##...........................#.....#........###...................E#####
####..........###.....................########......................................................###....................#####
####..........#.......................#####.#......................................................#####....................####
###.........................##.......#####...........#.............................................####.......................##
###.....#...................#........####...........##.............................................#..........................##
#.......###.........................####............#...................#.#............#........................#..............#
#...................................####.............#.................####...#...............................#####...........##
#..................................####................................####...#..........#...................#######......#...##
#...................#................#.................#................#......................................######...###.####
#................#######.........###..................######....................................................###########...##
##..............##########......###...................#####......................................................#########....##
##..............##########.....###..................#######...............................................#.......#######.....##
##...............#####.###########..................######...............................................###......######......##
###.............####.....########..................######.................................................##......######......##
##..............####.....########................#######.........................................................######.......##
##.............###........######.................#####...........................................................###.#.......###
#..............###........#.#.#.................#####.......###.................................................##...........###
##............###.....#.#........................##.......####..................................................##...........###
#..............##.....###................................####......................................###.........###............##
###.....##.....##.....####...............................###......................................######........##............##
###.....###.....#.....#####...............................#.......................................######........#.............##
#######.###............#####..........................................................#..........########.....................##
#######...##...........#####................................#........................####........#######......................##
#####.....##...........####...............................###......###...............#####......#########.....................##
#####.....###.........####................................#####..#####................######....#########.....................##
###.......###.....########..............................#######.######...............####################....................###
###.......#####...#########.......###............##.#.#.#...#.#...###.................#############...##.........#............##
##.......#####....####..####....######..........##########..........................#####....######...#.........##...........###
###.....#######....##....####.#.######...........########...........................###........##...............#............###
##....########....##.....###########.............##########.......................######....................................####
##...########.............########................##########...............##....#######.....................................###
#....########............########.................##########..............###...########.................................#.#####
#...########..............#####...................#########...............###...#######..####..................##......#########
#....####................#####.....................####.#.............#.###.....######.....###..................##....##########
##..#####................####......................####..............####.......#######...####.............#.#####...###########
#########...............#####.......................##..............#####........######....##............###########.####...####
###########.#...........####.........................#.#.............##..........########...............#################...####
#######...#####........######..........................###...........###..........#######.............#################.......##
######......###........#####.................#.........#####...........#..........########............##############..........##
######..................#.###..............####.........####..........###..........######............###.###########...........#
######....................####.............###..........####...........##.........########................########.............#
######.....................####...........####..........####............#...........####.....##...........########.............#
#####......................####...........###............##.................###..............###...........#######.............#
######......................####...........#............###.................####............###..............####.............##
#####.......................####.........................###.................##................................#.............###
######.......................###........................####..............................................................#.####
######...................................................###.......##.....................................................######
#######...................................................#.......#####................#..................................######
#######...........................................................#######............####..................................#####
########.........................................................########...........####....................................####
########..........................................................########.........#####.....................................###
########.........................................................##########........###......................................####
######........########........###.....................##..........#########........#........................................####
######.........########.....#####...................#####........#####.####...............................................######
####...........########....###.#.####..............######..............####......................................#.......#######
####.............######............####...........########...............##......................................##....#########
##.................##...............###.#..........######................###....................................###....#########
###.................................#######........#####.................###....................................###...##########
##...................................#.######......#####..................####.......................................######.#.##
##.......................................####......###....................####.#.#...................................####.....##
##.........................................###.....###.....................#######..................................###........#
#..................................................##......................######..............................................#
##..................#.......................................................####...............................................#
#.................####......................................................####...............................................#
##................####......................................................####..............................................##
#...............#######...##.....##...................................###..#######.......................###..................##
##..............#######.#.###....###..................................############........####..........#####...............####
##............###############...#####....................##......###################.....#####.........######...............####
####..........#################.############......#.#.################################.##########.....########......############
################################################################################################################################
