################################################################################################################################
#############..############################################....########################..##########################..###########
##########......##...####...#####.......############............#######.....####..###.........#######........####.........######
#######...............##.....###.........##########...............####.......##................#####..........##...........#####
######....###................###...........####..###........................##.................####............#............####
###......####.................#.....#.......##.....##........###...........###...............###..............###............###
##......#####......................###.............###.....######........####...............####..............######..........##
##.....######.......................###.............#.....######.........###................#####.............######..........##
##......#####........................###..................###................................#####...###....##.................#
#..........#..........................###.......##............................................##########....##.................#
#....................................###.......####...................................###.....#########.....#...........#.....##
#...................................###........####......###........................######....######...................###...###
##..................................##.........###......#####....................##########...####......................###..###
###..........#......................#.........###.......######..........##......######..##....###........................#...###
####........###....................##.........##..........#####.........##.....#######.........##............................###
####.......###........###.......######.......###...........#####...............#######.......................................###
####.......##..........#.......##########....###............######..............#######......................................###
###...........................############...####...........#######...##............###......................................###
##............................############....###............###############.........###................................###.####
##..............###...........###...######.....#.............################.........###...........##.................#########
###.............###...........##.....####.....................###.....#######.........####..........###................#########
########.........#..................####...............................######.........######........###...............##########
#########...........................####..............###..............######.........#######.........................##########
########...........................######.............###...............#####..............#......................##...#########
###........###.........###........#######.............###................####.....................................###...########
##.........####........####.......######..................................###......................................###...#######
###........####........####.......####....................................####......................................###...######
###...................####........###....................................#####................##.....................#.....#####
###...................###........###...................................######...........#....####............................###
###....................#.........###..................................######...........###..#####.............................##
###...####.......................##...................................#####.............#########.............................##
##...#####..................................##.........................####..............#######..............................##
###.#####..................................###..............#...........####.............######........#..............##.....###
########....................................##..............##..........#.##...###.......#####........###.............###..#####
########.............................#.........................................###......######........###..............#########
#######.............................###.........................##..............#.......######....#....##...##..........########
######...............................#.........................###......................######....##.......####..............###
#####.........................................................###........................####.............#####...............##
####.........................................................####.........................................#####...............##
####............................###..........................###...........................................###................##
####............................S#....................##......##..............................................................##
####..................................................##......##...............................................................#
###....##.....................................................##...............................................................#
###...####.....................##.............................#........................##.....................................##
####..####....................#######........................###........................#.....................................##
####..####..................##########.....................#####..................................#.....................##....##
####...####.................###########..................#######.................................###..............##....##....##
####...####........................####...............#########..................................####..####......####.........##
#####...##..........................###....##.......###########...................................##########.....#####.........#
#######....................................###......###....###.....................................##########....#####.........#
########...................................####.....................................................#########....####.........##
####..#......................####.......########.....................................................########....##...........##
###..........................#####......#########.......................................................#####................###
###..........................######.....###...####.............##.....###.................................####..............####
###..........##................####......##....####.....###...####.....#........................###........###..............####
####........####......#.........##...............#......####..#####...............###.........######.......###..............####
#####......#####.....###.................................###...####...............###........########.......................####
#####.....#####......###..................................###...##................##........#########..................###.#####
#####....####.........##......................##..........###................................########..........###.....####.####
###.....####...............................#####...........#.....................................####.........#####.....##...###
##.....###.................................#####..................................................##..........####.............#
##....###................##................#####...............................##..............................##.............##
##....###...............####...................................#...............####..........................................###
##....###...............####..................................###..............#####...............................##.....######
##....###..........###..###...................................###................###.............####.............#####...######
#.....###.........#####......................#########........###................................#####...........#######...#####
#.....##..........#####................#....##########.........#.................................#####........##########....####
##................#####...............###..##########............................................#####........###########....###
###................#####.............##########..................................................####.........###########.....##
###.................######..........######.............................................#........####.............#########....##
##..................#######........###.....#####......................................###.......###................#######....##
#..........##......########.......###.......####......................................####.......##..................#####....##
#..........###.....#######........###........##........................................#####...........#######........###.....##
##.........##.....######..........####................................###...............#####.........########................##
###.............#######............#####..............................###................##...............##..................##
###.............#######.............#####................................................##...............#...................##
####.............#####...............####........#####...................................##...............#..................###
####.................................####.......######..................................###...............#...............######
####................................######......######..................................###...............#...............######
###.................................#######.....#####...................................###...............#...................##
###.........##.......................#######....#####.............##...................####...............#....................#
###.........#............................####..########..........###....................##................#....................#
###.......................................##############..........##...........................................................#
##........................................#####..######...................##..................................................##
##.................................##.....####....####....................###.................................................##
##................###........##...#####...####.....##.....................####...........#####......####......................##
###..............######.....###...#############...........................####..........######.......###.............###.....###
####.............#######....###...#############............................##............#...........####............####...####
#####............###..###....#.........#######.......................##.............................##...............####..#####
######............#....###...............##.........................###.........................#####.................##...#####
##..#..................###..........##.............................###.........................#####........................####
#..................................####......................##...###..............###.........####..........................###
#.................................######....................#########..............###.........###............................##
#................................########..................##########...............##........####............................##
#.................................#...###..................###########.......................#####............................##
#......................................###................######..#####.....................######............................##
##......................................#................####......#####...................###..#.............................##
##.......................................................###.......#####................#####....#............................##
###..........#...........................................###........###................#####..................................##
###..........##..........................................####...........................#.....................................##
###......................................................######..................##...........................................##
##.......................................................#######................###...........................................##
##............................................##.........########...............###..........................................###
##..........................##.................#......#...########......###....####..........................................###
###........................###.......................##.......####......####..######..........................................##
#####.......................#..................................##.......############.......................###................##
#######..................................................................############.....................####.........##....###
########..........###........................................................#########...................######........###...###
##########........####................##......................................########........##......#########........##....###
##..#######........####...............###.....................................#######.....#######.....#########...............##
##...######.........#######...........###...............###....................##........########.....#########...............##
##...#####...........######............#...............####...............................######.......########...............##
##...#####...........####.............................#####................................#####.........######...............##
##...#####...........###....................####.......###..................................###............###................##
##...######.........###....................######..................##................##.......................................##
##......#####.......##.....................#######.................###...E......########......................................##
##.......#####.....###......................#######................#####.......########.......................................##
##........#####....####.............##......#######................######......########.......................................##
##.........####.....###............####......######........##......#######.....########........###............................##
##..........##......###...........######.....#####........####......#######.....######........####............................##
###..................#............######.....####........#####......#######..................####............................###
###...............................#####......####........#####......#######..................###..........#...............######
###...............................####........####........#####....#######...............................###..............##..##
###.......................##......####.........#####.......#####..########...............................###...................#
###.....................#####....#####.........######.......##############.........................#.....##....................#
###................###################.........#######......###############..#####...............####...###....######..........#
#####..#####..##..#####################...##################################################################..##############..##
################################################################################################################################
