################################################################################################################################
###############################........................................................................................#########
########....################.............###########...............#####...#######...###########............#######......#######
#####........#####...######....................................................##.....#####.................######........######
####..........###.....###.............................................................####.................######.............##
###...................................................................................####.................###.................#
###............................................##....................................####..................##.................##
###...........................................####...............#..##................##..............##......................##
##...................................##.......####..............#######..............................####.....................##
##...................................##........##...............#######.............................#####.....................##
##...................................##..........................######............................######.....................##
##..........................##.....................................#####........................########.....................###
###............##..........####.....................................####........................#######.....................####
###..##.......####.........#####.....................................##.........................######.....................#####
###..###......####.........######................................................................#####....................######
########.....####..........######.........................................................##......###.....................######
########.....####..........#######.......................................................####..............................#####
########.....#####..........#..##.........#..............................................####...............................####
########.....######......................##...............................................###................................###
##.#####......#####.......................#.....................................###..........................................###
#...####.......###.............................................................####.........................................####
#....##........................................................................####.........................................####
#..............................................................................####..........................................###
##..............................................................................####..........................................##
##...............................................................................####.....................####.................#
###...............................................................................####...................######................#
####..............................................................................####..................#######................#
####..................................................###.........................####.................#######.................#
###......................................###..........###.........................####................#######.................##
###..........................##.........#####.........###..........................###.............######....................###
##..........................####.......#######.........###........................................######.............####...####
##...###...................######.....########.........####.......................................######...........#.#####..####
##..#####..................#######..###########........####........................................#####..........##.#####...###
##..#####............##....#####################......#####.........................................###...........##.####.....##
##...####...........####....##############...####....#####........................................................##.####......#
###...##...........######....############.....##......#...................................###....................###.#######..##
###...............#######.....#####..####..................###.........................######....................###.###########
####.............#########.....###.......................######.......................#######...........##.......###.###########
####.............###########..####......................########.......................#####............###.......##...#########
###...............################......................########........................###..............##.............########
###................##############........................#######.........................................................#######
###...................##########.........###..............#####..........................................................#######
###....................#####...........#####...............###.......................#........................................##
###....................####...........######........................................###.........##.............................#
###....................####..........#######........................................###........###.............................#
###...................######..........#####.........................................####.......###.............................#
##...................########.......................................................####.......##.............................##
##.......#..........#########....................................##..................##.......................................##
##......###........##########.....................S.............###............................................................#
###.....###.........######.....................................###....................................................#........#
###.....###...........###......................................##...................##.................###...........###......##
###.................................................................................##................####............#.......##
###......................................#######..####..............................##............##..####....................##
##......................................###############.............................##............#....##....................###
##......................................###############.............................##.....#.................................###
#......................................###############.............................###.....##........##......................###
#................##...................#####..########..............................####.............#####....................###
#...............####..................####....######...........##..................####.............######....................##
#...............#####.................####....#####...........####.................###..............######....................##
#...............#####.................###.....####............#####................##..............########..##...............##
#................###...........................##..............#####................#.#..........######.########..............##
#..............................................................#####..................#####.....######...########.............##
#.............................................................######.................#######....#####...#########..#.#........##
#.....................................................##......#######...............########....####....########...#.#........##
##.............#......................................##.......######...............####.##.....###......#..###....#.#........##
##............###...............#....................###.........####................#..........##.................#.##.......##
##...........####..............###..................####..........###..........................###.................#.####......#
##...........####..............####.................####..........###.......................#######..................#####.....#
##............##...............####..................##....................##..............#########.................######...##
##..............................###.......................................####..............#######....................#########
#........................................................................#####................##........................########
#........................................................................####..............................................#####
#....................................###.................................####...............................................####
##..###......................##......###............##....................##................................................####
#######........#............####.....##............####......................................#########......................####
######........###...........####............###....#####....................................##########.......................###
###...........###...........###............####....######..................................##########........................###
##...........####...........##..............###.....#####...................................##...............................###
##............##.....................................####....................................................................###
##....................................................##......................................................................##
##............................................................................................................................##
##........................................................................................................##...................#
##.....................................##.................................................................##...................#
##................##..................###......................#.............##...........................##...................#
##...............####..................##.....................###...........####.........................####..................#
##...............####.........................................###...........####.........................#####................##
##.....###........###.........................................###...........###...........................####................##
##....#####...................................................##............###...............................................##
##....######................###...............................##............##.....................................#..........##
##.....#####...............####............................................###....................................##..........##
##......###................####...........................................###.....#...........................................##
##........................................................................##......##...........................................#
##...............................................................................####..........................................#
#......##........................................................................####..........................................#
#......####...........#................###........................................##........#..................................#
#......######........###...........########................................................###...........................###..##
#......#######.......####......############................................................###..........................########
##....########......######....############..................................................#..........................#########
##...########.....#########...#########..............................###................................................########
##....##.........#####..##.....#######...............................####..........................E........................####
##..............#####...........######.................###...........####....................................................###
##.............######............#####................#####..........####....................................................###
##..........########..............####.................###..........######....................................................##
##..........#####..................###..............................######....................................................##
##..........####....................##..............................#####....................................###..............##
#............##......................##..............................####.................................#######.............##
#............##......................##...............................##..................................#######.............##
#............##......................###.............##.............................................#.....#######.............##
##..................................#####...........###......#.....................................###........##..............##
##.................................######...........###.....###..###..............................###........................###
##.................................#####.............#.......#########...........................####........................###
#..................................#####.....................##########.........................#####...........##...........###
#..................................####.......................#########........................######..........####...........##
##............##..................#####........................###..##.........................#####...........####...........##
##...........####................#####.........................................................#####............##............##
##............##................#####...........................................................####.................##.......##
##..............................#####............................................................##..................###......##
##...............................####...................................###........................................#.###......##
##................................###................................######.......................................##.###......##
##..........##....##...............##................................######.....##...............................###.####......#
###........###########...............................................##........####.................##..##......####..###......#
####.......############........................................................####................########.....###....###.....#
####........###########..............................##......##.................##.................########.....###....#####..##
##...........##########.............................####....####....................................##.........####....#########
#...........###########...........###..............#####.....###..............................................#####.....########
#........##############....##....####.............#######....####....................###.....................######.....########
##..##..################..############...........#################............###...#####....#######################...#########
################################################################################################################################
