################################################################################################################################
####.........................................................................................................................###
####......................######.####...............####.......#######.......###########.......#################......###.....##
####.......................####...##.................##.........#####.........#####..##.........###############...............##
####.......................####.................................#####..........###.....................#########.##...........##
####.###....................###.........##.......................###...................................#############....##....##
####.####...................###........####.............##.............................................####....######..###....##
####.####....................###......#####.......#....####............................................###..........######....##
##...####....................###.....######......###...#####..............##...........................###...........###.....###
#.....##....................#####...#####........####...#####.............##...........................####.................####
#...........................######..####.........####...#####.........................................#######...............####
##...................##......#####...###.........####...######........................................#########...###.......####
##..................####......###....###........####.....#####............................................############......####
##..................####.............###.......#####.....####....................##........................##########.......####
##...................##.......................######......##....................####........................#######..........###
###...........................................######......##....................#####.........................................##
####.######......................................##.......###....................#####.....###...##...##......................##
####.#######..............................................###......................###......#...#########..........##.........##
####.########.......................##....................###...................................###############...#######.....##
####.########...............#.......##....................##............##.......................##...####################.....#
####..######...............###...........................##............####............................####################....#
###....####......###.......####..........................##............####............................####################....#
###....####......###.......####.........................###.............##..............................###################....#
####....###......####.......###.............###........####...###........................................###########..#####...##
####.....#.......#######....###....S...#########......############.......................................#####.####....##.....##
####.............########..####.......#########.......############........................................###...##............##
####.............###############...###########.........############.......##..............................###.................##
###...............#########################............#####################..................................................##
##....................####################..............#####.##############..................................................##
##......................###..#############................##...##########.........................................###.........##
###...........................#############....................#########..........###............................####.........##
###............................############....................########..........#####..........................#####........###
###............................############.....................#####...........#####...........................#####.......####
##......................##......##########.......................................###......#####..................####.....#.####
##....................#####......######.................................................########..................##.....##.####
##.....####..........######.......####.................................................#########........................###.####
###...######.........#####........###..................................................#########.......##...............###.####
###...######.........###.........####...................................##.............########.......####...###........###.####
###...#####.........###.........####..................................#####............#######.......#####...###.......####..###
###....###..........###.........#####..........###...................######............######........####....##.......####....##
##............##....###.........#########.....######.................#####.....###......#####........###....###......####.....##
#............####...###..........#########....#######.................###.....#####.......###................#......####......##
#...........#####...###...........########.....#######.......................#######.......###.....................####.......##
##...##.....####...####.................###.....######.......................########.....#####...........#.......#####......###
####.##......##...######.................###.....####........#..............##########...######..........###.....######......###
####.##...........#########...............#......####.......###..........#####################..........####....########....####
####.##..........###########.....................####.......####........########.##########.............####....###########.####
####.###........############......................###........####.......#######...#######...............####......#########.####
####.####.......############..................................###.......########..######.................####.......#######.####
####.#####......###########...................................###.......#########.######........#..........######...#######..###
####.#####......#####..........................................#.......##########..#####.......###..........#####...######....##
####.######....#####..................................................##########....####.......##...........#####...#####.....##
####.##############.....................................##............#######........####.....###............#########........##
####......########........##.............................##............#####.........#####...####.............#######.........##
###........######........####............................###...##........###.........############.............######..........##
##..........####........#####....###.....................#########...................############.....####.....#####..........##
##..........###.........#####....###..............###.....########...................############....######....####...###.....##
##...#.......#...........####....................#####.....#######...##..............######..###.....######.....##...#####...###
####.##...................##....................######......#####...####.............####............######..........#####...###
####.#..........................................######......####...#####.............###............######............###....###
####.............###........................#....#####.....####....######...........####............####.....................###
####...........######..........###.........###....###....######.....#####..........######............##......................###
####..........########........#####........###....###...#######.....######........#######...................##................##
####..........########........#####........####....##...########.....######.......#######...............########..............##
###..........#########.........###........#####..........#######......######......#######..............###########............##
##.........##########.....................#####...........######.......#####......#######..............####....####..........###
##.........##########.....................####.............####.........####.......#######............####......####.........###
##...##.....########.......................##..............####.........###........##########.........###........####........###
####.###.....######...............................#........####.........###........###########....................###........###
####.###.....######..............................###.....######....................###########...............................###
####.###....#######.............................###.....#######.................########...##.................................##
####.##.....###########.........................###......######................########.......................................##
####.##.....############.......................###.......#######..............########..............................##........##
####.##......###########.....................#####........######..............########.........##..................####.......##
####.##......###....#####....................######.......######...............######.........####.................####.......##
####.#......###......####.....###............########.....############..........#####........####.............#.....##........##
###........####.......###.....####.............#######...##############..........####........###.............###..............##
###.........##........###.....###................###########..#########..........#####.......###............###..............###
###..................###..........................########......######...........#####.......####..........###..............####
###..................##.............................#####........##.............#####........#####.......####...............####
###.................##...............................###.......................#####.........######.....#####...............####
####................##.....###.................................................####...........#####.....####.................###
####...............###....####................##...............................####............####......##.........###.......##
####................#....#####................####....................#........#####...........####............#....####......##
####....................####.....................#...................###..##..######..........#####...........###....####....###
####....................###...........##............................###############...........#####...........###.....#####.####
####....................##..........#####..........................############...............######......#....##.....#####.####
####.........###.......###.......########.........................###########.................#######....###.........######.####
####........#####......###......#########...................##.....#..######.................#########..####.......########..###
####.#.....########...####......###..###...................####........####................#################......########....##
####.##....###############......##.........##..............####...........................######...#########.....########.....##
####.###..###..###########......##........####..............##..................##........#####.....#######......########.....##
###..#######....##########......##........####.....#...........................####........####......######.......#######....###
##....######....#########.......######....####....###.........................######........####......####.........######....###
##....#####....#########........#######....##....######.............##........######........####.......###..........#####....###
##...####......########...........######........########...###########...........###........####.......##....................###
#....####.......#######...........#######.......########..############............###.......###.......###....................###
#....#####......#######...........#######.......###.####..####..######............####.....####.......###.....#..............###
#.....####......#######...........#######............###...##....####...###.......####.....####........##....###............####
#......##.......#######..............###.........................####...####.......###......##.........##...###...........#.####
##.............#######......###.............###...................###....###.......###.................##..####..........##.####
##.............#######.....#####............#.##..................###.....##.......###.................########.....##...##.####
##............#######.....#####...............##...................##.....###.....####.....##..........#######.....########.####
##...##......####.....................##.....................###....##....###....#####....####........#######......########.####
#....###.....###.....................####...................####....###...###....######...#####.......######........#######.####
#....###.....##......................#####.................#####.....#...........######...#####.......####...........######.####
####.###.............###.............#####...............######...E..............#####....#####.......###.............#####.####
####.####...........####.............####...............####.....................#####.....####......###...............####..###
####.#####.........####...............##.........##...#####......................######.....####....####...............###....##
####.######........###..........................####..####........................######.....###########...............###....##
####.#######..................................######..##..........................######.............###...............###...###
####.....###................................#.#####................................####.......#########................###...###
###......##................................######...................................##........#######..................###...###
###......###.##..........................#######.............................#####.####........#####..................####...###
####....########........................########.............................############......#####......#.......#########..###
####...#########........................########..............................############......####.....###.....###############
####..#########.........................########.................................########.......####......#.......##############
####..#########..........................#######......................#...........#####.........####...............#############
##############..........###..........................................###..........#####.........####................############
########...............#####.........................................###...........#####.......#####.................###########
#######................#######.......................................###............####......#####...................##########
#######................########......................................###.............###......####........###.........##########
#######.....###.........#######.....................................#####..............................######.........##########
######.....#####..........######....................##.............######........................############........###########
#####.....######...........#########...............####...........########......##.........##...###########.........############
####......###########.....###########....##........#######.......##########....####..###..###############......#################
#####....#############################..#######...##########################.############################...####################
################################################################################################################################
