################################################################################################################################
##.......############...###################################.####...####################..#######################################
#.....##.###########.....##########........####..#########............###########..##.....###..############...######...#########
#......#.###########........######..........##....########................######................##########.....####.....########
#........###########.........####.................#########...............#####.................##########......##......########
##........###########........###..................###...####..............####.................##########...............########
##.........############.....####......#...........##.....#####.............##.................#######....................#######
##.........#############....####......##..................####................................######........................####
##..........############....#####.....#.....................##................................####...........................###
##..........###########......###.....................................................##......####......####...................##
##..........##########................................................##.............#......####......######..................##
##..........#########....###........###..............................####....................#.........######.................##
#...........###..........#####......###....................##........####...............................#######..............###
#..........###............####.......##....................##........####................................######..............###
##........####..............##.............................###........####..#............................######.............####
###......######...........................................#########.....######....##........................................####
###......#######........##..................##...........###########.....#####...####.....###..............................#####
###......##....#.......####...............#####..........############.....###...####.....######.............###............#####
###...................#####.............#######..........############...........###.......######............####..........######
####.................######....###.....###...#...........#######..##............###.......########..........###..........#######
####................#######....##########................######..................#........########.......................#######
#####................#######....########..................###............................########........................#######
#######...............#######....######..................................................####............................#######
########.......#......#######......####............................########.............####..............................##...#
########......###.....#######.......###.........###........##......#########............####...................................#
########.#...####......##...........###........###############......########.............##........##.........................##
########.#########..................###........################......########.....................####........................##
########.############..............####.........################......#######.....................####.......................###
########.....#########...........######.....##.#################.......######......................###.......................###
########......#########........#######.....#########......######........#####.....#####............###........................##
########.......###...###......#####........########........######.......####.....######............####.......................##
#########.....####...###......####..........#######.........########...#####....#######........#########......................##
##################....#.......###............#####...........################..#######........##########.....................###
#################.............................###.............##..################...........##########......................###
################.....................................................############...........########........................####
###....#######............................###.........................#########............########......................#######
##......#####...............#.............###.........................########............#####................###......########
##......####....##.........###............##.........................########.............###.................#####.....########
##.......##....####........###...........###.............####......#########..............##..................#####....#########
###..........######........###......########............#####....#########...................................#####.....#########
####........######.........####....##########...##.....######...#######.....................................#####.......########
####........######.........####....##########...###########.....######...................................########........#######
####........######.........#####..####....##.....#########.......#####..................................#########.........######
####........######..........#########.............########.......#####....#............###..............######.............#####
####........####.............#######...............#######........###....###..........#####............######..............#####
#####.......###.........#.....######...............########.......###....####........######........##########..............#####
######......###........###....#####.................########.............####........######.......############............######
######......###.........##....####.....................######............####........#####........############.........#########
######..................###...####......................#####............####..###...####..........###########.........#########
#####..................####...####.......................###.............###############...####....###########...............###
###....................####...####.......................................###############..######....##########................##
##......................##....####.......................................##############...######.....########.................##
##............................###...............................##.......###########......#####.........####.........#........##
##............................###...............................###......###....###........##............##.........##.####..###
##............................###...............................##......###.......................###...............##.#########
##.....................................................................###..........###..........#####.............###.#########
###....................##..............................................###.........#####.........######...........####.#########
#######................###...........................#..................#..........########.......#########........###.#########
#######.##.............####.........................###...........................##########.......#########...........#########
#######.#####...........####.........................##........###...........###############........#########............#######
#######.########........####..................................#####..........##############..........########.............######
#######.#########......#####.................................######..............###.................#########............######
#######.#########.....#####...............##..................####...................................##########..........#######
#######.#########....####...............#####.........................................................##########........########
#######....#######..####...............#######..............................................................####.......#########
#######.....############................######...............................................................###.......#########
##..........############......##...........###........................................................................####..####
##..........##...#######.....####.....................................................................................###....###
##.........###....###........####.....................................................................................###....###
###.......####...........S..####.......................###.......#..........................................................####
####......####..............####.........#............######....###.....#####..............................................#####
####.......##..............######.......###...........#######...####...######................###...........................#####
####..................############.....###...........########...#####...####.................########......................#####
###..................##############.....#............#######.....####..........###...........#########.....................#####
##.....##....###......##############..................###........####.........#####.........##########......................####
##....###########.......######..####..............................###........###########...###..######................##....####
###..############................###.............................####........################......##................###.....###
###########...##.................###..........................#######.......#################.......................####.....###
##########...................##.#####........................########......##################......................#####.....###
#######.....................##########.......................#######......####################.....................######...####
#####.......................###########....##.................####........##########..######........................############
#####........................##..#######..###..................##........##########....########......................###########
#####.............................######...#.............................##########.....#######........###............##########
#####..............................#####.................................##########....########.......#####............##..#####
#####................................##...............###......................###....########........#####.................####
#####.................###.............................###.............................####............#####......##........#####
####...........###....###....#........................##..............................###..............###......###.......######
###............####..####...###.................................................................................###......#######
###............#########...####..................................................................................#......########
###............#########...####.........................................................................................########
###.............########....##..................##.........................#..#.........#................................#######
####....#........#######.............#######..######......................######.......###...............................#######
##########.........####............##################.....................#####........###................................##..##
##########..........##............###################......................###.................................................#
##########........................###################.........................................##...............###.............#
##########.........................######..##########........................................####.............#####...........##
######..#............................###....#########................##.................###..####....#........######..##......##
######.........####.........#................#######................###.......###.......###...##....###........##########....###
######........#####.........##................#####................###......######......##.........####.........##########..####
#######......######..........###..............####.....###........####.....######.......##.........####.........################
#######....#####..............#######..........###....#####.......#####..######........###.........####..........####..#########
######....#####...............########..........###....####........###########........###...........##............##....########
######...####................#########..........####....##..........##########.......####................................#######
#####...####.................########............###................##########......######...................................###
#####....##..................#####..............####................##########......#######...................................##
#####.................##.....####............#######.................##########......######..................................###
#####................####.....###...........########.................###########....E######.....................##..........####
#####................####......###...........########...####........#####...#####.....####......................#...........####
#####................####.......####..##.....################......#####.....###........##...................................###
####.....##...........###.......#########...##################....####.......##..........##..................................###
####....####..........####.....###############################.....##...##..###..........###.................................###
####....####..........####....#################...###########..........#########.........###.................................###
####.....###.........####.....################..........####...........#########.........####....................###.........###
#####...............#####......###############...........###............########.........####......###..........#####........###
######..............######....################..................##..........#####.........##.......####.........######.......###
######...............#########################.................####..........####..................####..........#####........##
#######...............#######################..................####...........####.....##...........##............###..........#
#######................##################.......................##.............##.....####.....................................#
########..........##...#############.##...............................................####.............................##......#
########.........####...###########....................................................##..........##.................####.....#
#######..........#####....#########..........####.................................................####...............#####.....#
######...........######....########.........######...............................................#####...............####......#
###..............######....#######..........######...................##..........................#####...............####.....##
##...............######...#######...........#####....................###..........###.............####........##.....####....###
###...##........########.########..........######....................####........#####......###...#####......####.....##########
#########......###################......##########....###...........##########..################..######....#####.....##########
##########..#######################....#######################...#################################################...###########
################################################################################################################################
