################################################################################################################################
################################################################################################################################
################################################################################################################################
################################################################################################################################
################################################################################################################################
################################################################################################################################
################################################################################################################################
################################################################################################################################
##############################################################################################.#################################
###########################################################################################.......##############################
##########################################################################################.........#############################
#########################################################################################...........############################
########################################################################################.............###########################
########################################################################################.............###########################
########################################################################################.............###########################
#######################################################################################...............##########################
########################################################################################.............###########################
########################################################################################.............###########################
########################################################################################.............###########################
#########################################################################################...........############################
##########################################################################################.........#############################
###########################################################################################.......##############################
##############################################################################################.#################################
################################################################################################################################
################################################################################################################################
################################################################################################################################
################################################################################################################################
################################################################################################################################
################################################################################################################################
################################################################################################################################
################################################################################################################################
################################################################################################################################
################################################################################################################################
################################################################################################################################
################################################################################################################################
################################################################################################################################
################################################################################################################################
################################################################################################################################
################################################################################################################################
################################################################################################################################
####################...#########################################################################################################
####################...#########################################################################################################
####################...#########################################################################################################
################################################################################################################################
################################################################################################################################
################################################################################################################################
################################################################################################################################
################################################################################################################################
################################################################################################################################
################################################################################################################################
################################################################################################################################
################################################################################################################################
################################################################################################################################
################################################################################################################################
################################################################################################################################
################################################################################################################################
################################################################################################################################
################################################################################################################################
################################################################################################################################
################################################################################################################################
################################################################################################################################
################################################################################################################################
################################################################################################################################
################################################################################################################################
################################################################################################################################
################################################################################################################################
################################################################################################################################
################################################################################################################################
################################################################################################################################
################################################################################################################################
################################################################################################################################
################################################################################################################################
################################################################################################################################
################################################################################################################################
#################################################################################################....S...#######################
#########################################################################.#######################........#######################
#####################################################################.........###################........#######################
####################################################################...........##################........#######################
###################################################################.............#################........#######################
##################################################################...............################........#######################
#################################################################.................###############........#######################
#################################################################.................###############........#######################
#################################################################.................###############...................############
#################################################################.................##.#..............................############
################################################################...................#.#..............................############
#################################################################.................##.#..............................############
#################################################################.................##.#..............................############
#################################################################.................##.#...............E..............############
#################################################################.................#..#..............................############
##################################################################...............##..#..............................############
###################################################################.............###..#..............................############
####################################################################...........####..#..............................############
#####################################################################.........#####..#...............####...........############
#########################################################################.#########..#...............###########################
###################################################################################..#...............###########################
###################################################################################..#...............###########################
###################################################################################..#...............###########################
###################################################################################.############################################
###################################################################################.############################################
###################################################################################.############################################
###################################################################################.############################################
###################################################################################.############################################
###################################################################################.############################################
###################################################################################.############################################
################################################################################################################################
################################################################################################################################
################################################################################################################################
################################################################################################################################
################################################################################################################################
################################################################################################################################
################################################################################################################################
################################################################################################################################
################################################################################################################################
################################################################################################################################
################################################################################################################################
################################################################################################################################
################################################################################################################################
################################################################################################################################
################################################################################################################################
################################################################################################################################
################################################################################################################################
################################################################################################################################
################################################################################################################################
################################################################################################################################
################################################################################################################################
################################################################################################################################
################################################################################################################################
################################################################################################################################
