################################################################################################################################
###....................S........................................####################.....######.#########.#.#.##################
###.###########################...............####.#####...............##########.........###.....#####.........#########...####
###.......#.####.#.#.########.................#........................##########.........####....###.............###.###.....##
##...........#.........######.............................##............########..........####........................###.....##
#...........####.........###.............................#####.........########...........#..#.#......................####.....#
##...#......###..........####..............................####...##...########................#.#...................#####....##
#....#......####..........###.................##...........####.#..#...#######..................###.......#...........####.....#
##...#.......#......#..#.#####................###............##.#......#####.......#............###.......##..........##......##
##.#.#......##......###########...............####............#.#......##.......................###......###....#.............##
####........#.....#########.#.................#######.........#.#.....###.......................###......####.####............##
#####......##.....#######.....................########......###.##....##......................####........###..#####.........###
####.....#.#.....######.......................#######.......###.##............................#####..............#####.......###
#####..#####.....######.#.....................#######.....#####.#...........................#######..............#####.......###
############.......########...#...............#####......##.................................#.#####................###.......###
#############......#######..#####.......................###.....................................#####.........................##
#############.......##############......................###....................................######.........................##
########.#####.......####...######......................##................###...................###########.......#...........##
######.....####.....##......######...............####...####..............###...................############.....####.........##
######......###.....###.....###..###....###.....#####....###....##.........##....................####.######....#####........###
######.......###....##......##....###..####.....#####...######...##...............................#...#######....##.#.......####
#######.......##....###...........###..###.......##.......####..##......................................######...##...#....#####
##..###..............#...#.......................###......#####.####....................................#.####....#.####.#######
#..####..................#.#......................#......######.######....................###..............####..###############
##.#.##..................#.##............................######.#######..........##..#######...............####...##############
##...#.................................................########.########............#########...............####################
##....#.......................................##.......#######....####............##########...............#####################
##..................#......................#####.....#########.....####...........###########....##........#####################
##...........###...######...................#################........##.........############....####........###....#############
##............#.....######......................##############.....#####.....###########.####....####.................#.########
##.#.#...............#####......................########...####...######.....##########...##.....#####..................########
##..#..................####.....#................######......###########......#########.#.###.....#######................###.###
#..###.####............###.......####...........#######.......###########......####.#####.....#.#..#######..............####...#
#...########.......................##............######........###########...........####.....############..............##....##
#####...####.......................###..........#####.###.......##########............##......###....#####..........#...###....#
######....#.#.......................##........#####...##........###...#####............#.............#####.........##....#....##
#####.......#..........###..................######.....#.............#######.........#...............####..........##..........#
#####.......###........#####................#####.....................######.........##.............######.........##.........##
#####.......####........###.................###......................#########.....####............#######....................##
######.....#######.......###..........................................###########...####...........#######....................##
#######...########...................................................###..##############.#.....#.#.#######.....................#
#######...##########............###...###............###.............#......#.##########.###.###.#.########...................##
######...############............###..###...........####...........###.........########..#####.#.##########...........###......#
####....##########...............#......#..........######.........###............#######...#.....############...#......####...##
###.....########....##............................###.#..........####............######..........#######.###....#......####....#
#......#####...#.....##......................................#.#####...............#####........########...#######.....#####..##
##......####...#.....##.........................###........#.#.######.............######........#######.......####....#####...##
#.......###.....#.....###.....................####........###..#######............#####.........#######.....#####......####...##
##........#....##.....###.....................####.........##...######..........#######...........#.##......######....####.....#
#.....................######.#........................#...###...######.....##.#.######..............#.#.....#####.....####....##
#.....................#############..................##........#####......#####.#.####....................########.....#......##
#....................###############.................#..........####......####..........................#########............###
##....................#############.............................##.......####............................########...........####
##.....................############.......###............................###..................##...........................#####
###......................####.####........##............................####..........#.......##......................#.#....###
###......................##...####........#.#..........##..............####...........###....####...##..............#######...##
####............................#.....................####.............####.........####....####.....#..............#####......#
###...##.........###....................................#.......#......###.....##########...#####....#.............###.........#
#########........####.........................................####.............##########.#####.#....#.............#.#.........#
########.......######........................................####...............#############.#.#.#.###............#..........##
#########.....######...............................###.......####...............###########.....#######..........#####........##
#########.......#........####......................####......##.................###.######.....#######..........#######.#.#.####
#########................#####.....................####.......##................##..####.......#######...........#...###########
########................######.......#..............####.......#..............###.#........#.########.................##########
########...............#######.....####.............#####......#................#.#......###########..................##..######
######...................###......####.....#.......#######....###............##..........########......#.#.............#...#####
#######...................#........###....####....########....##............###..........######........##........#........######
#######......#....................###......###...######.###....##.####.......##..........#########...###.......####...##########
#########.....##...................##......####.#####...###...##...###.......##.........#########....#................##########
##########.....................#.####......###...###......###.##...####.................########.....................###########
#######.#....................#######......####.....#......######..#####................#########.....................###########
#####...................#....#######......###.............#######.#####................#######...........##.........############
####...................##....#####........#..............#############.......###......####.#.............##.........############
##.....................##......###.....................###.#.#########.......####....####.................#.........#######...##
#..............................###.....................###......#####.......####......####................#.#......#######....##
###............#................###..........#..........#........#.#.........###......####................###......######.....##
####..........##....#...........###........####..................#...........###.......####...............#####.....####......##
####.........####..###...........##.......#####...........#.#................###.......###................#####.....####......##
#####.......####..####....................#####...........####...#............##.......####.................#.......#.#......###
######....#.#####..###....................######.........#####...##...........##.......###.........##.......................####
#####...########...........................#####.........#####..###............#........####.......####.....................####
#####..#########............................###.........####.....#......................####.......####.....................####
####.....#.#.#...................#............#..........####....#.......#...............####.....#####.....................####
###.............................#.............#.#.......####.............#.................#.......###.......................###
####............................##..........######........####...........##.......................###.......................####
###..............#.............##...........######........#...............#........####......................................###
####............##..............#...#........######.......................#........#####........#...........................####
#####...............................###.........###..................................###........###..........................###
#####...............................####..........#...........#............##........###.#.....####..........................###
######...............................##...................#.#.#........#..###........#####......#####........................###
######.............................#####.................#######.....########.......######.......####.................#.....####
#####..............................####..................######.....#####.####.....#######.........####...............###...####
###..............................#####..................########.....###...###......######.........#####.............###...#####
#..............................#####.................................###....###.....######...........##...........##..##########
##............................######.............#.......######....#.#................####..........###...........##############
#............................#####...............#####.....###...###....................#..............................#########
##............................##.................#######.#####....#..................................###............############
#.........###.............................#####....#########....###................###.................#..............##########
##........#.............................########.....##########.##..................##...............................###########
#..................................##.#.#########....##############................####...............................####.#####
###.####.........................##########..#####.....############.................###..............................#####..####
########........................##########...#######...#############..............######.............#.#...............##....###
########........................###########...######.##############..............######.............######.....######.#####.####
#####...........................#########...########.#########.#..................#####.............########....####...###....##
#####.......................##.......####..###..####.########.....................####..............#.######...######.........##
####........................##..............###........######......................###..................#####....###..........##
#####.......................####...........#######......#.####.....................####...................##.....####.........##
#####........................##.............#####.........####.......................###......................................##
#####......................................########.#......###.......................###......................................##
####...............................###.....###########......#.........................###....................................###
##.................................###.....###########......#........###.............###.....................................###
##.................................##.....###.#########..............##....#....................###........##.................##
##..............................................######...............###.#####.................####........##...........##...###
##..............................................####...................########.................#.........####.........#####.###
#....................................................................#########.............................##..........#########
##...................................................................#########............................####..........########
#.......................#....................................##.....#########.........##................#.###..............#####
##....................###................................#.#.#......#########.........###.............#######...............####
##.........####.......#.....#.#................####.....####........########..........###..........#.#######.................###
##....E....####.........#######..............#######...###.#..........#.#...............####......##.#.#####..................##
###.........#.#.........########.............#######..###.......................#.#......##......#.....#####...........##.....##
##.....................#########.............##########.......................#######....###.............###..........###....###
###.....................#..####.......#.......#######...........................#.##......#..........#.#.###.................###
##.........................#####.....####......#####......................................#.#......#####.###.....##....#....####
##.................##.......####.#.######......#####....................................#.####....##########.....#######...#####
##...........#...#####.....##############.......####......#.#.....#......###.......#....#####################...##########.#####
####.#####.############.#.#################...###############.#.############.....############################.#.################
################################################################################################################################
