################################################################################################################################
##..........................................................................................................................####
##.##..###############......#####.....##########......####...................############.###############.....#############.####
##.##.......#########........#####.......#.#.####.....#####..................######.#.#.....#######.#####.....#############.####
##.#........#########........####..............#......#####...................#####..........#####....#.......#############.####
##.#.........###.#.###......######..........S..#.......#####..####............###.............####............#############.####
##.##......#####............#####......................#####.#..###............##..............#####...........############.####
##.###.....####.............####........................####.##.#####.........###...............#####............##......##.####
##.###.#.######..........##.###........................#####.#...####..........#.................####.......................####
##.###.########...........#.###........................#####.##...#####...........................###.........................##
##.....######.............#.####......................######.#.....#.###......................................................##
##.....#####..........................................######.##................................................................#
##.......#.........................##..................#####.##.........................................................#......#
#.................................###..................#####.###.............................##...............#........###.....#
##................................#....................#####.###...........................####.............####........###....#
#......................................................###...#####.........................###............######.......####....#
##......................................................#....######.....##.................####...........#####.........##.....#
#.......................................................##....#######....#..................###.#.##......######.......###.....#
##.............................................................#######......................########......#####................#
#...............................................................######...........##...........###.#........###.................#
##...............................................................#####............##...........................................#
##.......#........................###...................##.......####.............##...........................................#
##......###.......................####..................###......####..........................................................#
##......###.......................###..................###......####................................##........................##
##......##........................##..................####.....#####................................###......................###
#........##.......................#...................####.....###..........................................................####
##......##........................##......###........####.....####........#.................................................####
#........##.......................##.....###.........####......##......#####................................................####
##......###.......................####...###........####......####....#######...............................................####
##......###......................#########..........####......###.....#######.....................................##........####
##.....#####....................##########..........####.....######...#######......................................##........###
##......####.......#...........#########...........######....######...#######......................................##........###
##......###.......####.........#...#####...........#######...################.......................................##.......###
##.......##.......#####......###....####...........########....######.#######.........###...........................###.......##
##.#..............######.....###....####...........#######.......####...#####........###.............................##......###
##.#............#########...###.....####..........########........##...######........####....................#.......###......##
##.#............########............####..........########..............#####.......####...................####......##.....####
##.#............########...........######........#########.............#######......####...................###.......####...####
##.#............#######............####...###....#########.............########.....###...................####......#####.#.####
##.###...........#######..........######.####...######..###............##########.#.#.....................###.......#######.####
##.###.####.....#######...........##########.....#####..###.............###########.......................###......########.####
##.###.####......######...........###########...######...###...........##########.........................##........#######.####
##.###.#####....#####..............##########..............#............#######...........................##............###.####
##.###.####....#####...............##########..............................##..............................#..............#.####
##.#.#.####....####.................#########.......................#########.............................###.............#.####
##............####..................#########.......................########..............................###.#.#...........####
#............#####..................#########.......................########..............................#########.........####
#............######..................######..........................#########............................##########........####
#............######......##............###...........................###...##............................##########.........####
##...........#########.####.....##.......................................................................###########........####
##...........#####.#######.......##.....................................................................############.........###
##............##...######........#......................................................................############.........###
##...................###..........##....................................................................##############........##
##...............................###........#.............................................................#.####...###.#......##
##................................####....###........................................................................###.......#
##...............................############............................#...........................................####......#
##.##............................############...........................##............................................###......#
##.###.........................#############...........................................................................##......#
##.###...........................##########..####..............................................................................#
##.###.............................########..####........................................................#...................###
##..##............................####...########................##.....................................###.................####
##.....##..........................##....########.............#####.....................................####................####
#......##..........................#.......########..........######...................................######......#..........###
##......###...............................#######............#####...................................######.....###...........##
#.......####..............................#######.............##.....................................#####.....#####..........##
##.......####............................######.....................................................#####......####............#
#.......................................#######.....................................................####........####..........##
##....................#.#.#.##..........######.......###.............###....##......................###........#####...........#
##..................#######.#..........########....#######.........###.....####.....................##..........#####.........##
##.................########............####.....############......####.......###...................###.........######.......#.##
##..............#.#######..............##.....##############.########.......######...........##.....###...#.#...####........####
##.#............#####................#####......############.#######.........###..#####.....###....####.#####...####........####
##.##............##..................#####.....#############.########......#####...##.......####...######.#.......#.........####
##.###...............................#######################.#.###########.###................#########.....................####
##.###.#..............................######################.....##############...............########......................####
##.###.###...............................##################........############...............#########.....................####
##.###.####..............................###################.......##############..............########.....................####
##.###.####................................#############.#.#........########.#####............#.#...#####...................####
##.###.####..............................#.#.###########...###....#########....###............#.....#####.E.................####
##.###.####.............................##...#########.......##############.....##............#.......####..................####
##.###.####.....###....................####....#######.........#####.#####....................#......#####..................####
##.###.####.....#####.#.#..............###.....######..................###............................##....................####
##.###.####.....###########.....#.....####......####....................#............####.....................................##
##.###.#####....######.####....##......##........#.............................#.....####...................#......###........##
##.###.#####.....##......##...................................................##.....####.#................#####.#####........##
##.#....######..........###...............................................#.#..........##.##...#..........##########...........#
##.##...#######.#........##.............................................########........#.##.###..........##########...........#
##.#....##########......###...........................................########............####.#..........########.............#
##.###.###########......###.............................................#.#.#..............#..............########.............#
##.###############.......##.#......................................................................#....#########..............#
##.##############........##.#.....................................................................##############...............#
##.############..........##.#....................##...............................................##############...............#
##.############.........###.#...................####......#......................................##############................#
##.#.#.#######......#.#.###.#............##.....#####...###.......................................############................##
##.......#####......#######.##............###...###########...........###..........................###########.................#
##........####.....########.###...........##....##########...........######.........................########..................##
##.........###.....########.#####...............##########...........######.........................########..................##
##..........##.....########.###########...........########...........#######........................########..................##
##.#........##...########.#.###########...........########...........#######.................###....########..................##
##.###.......#.#.#####.......##########............#######............########.............#####...#########..................##
##.####........#####..........########..............######.............#######..............####.###########..................##
##.###.........####............######...........#.######.#...............#######...........#####.###########........###......###
##.####..........##.............###...........##########......................######.......##################.....#####......###
##.####..........###...........................#.#####.......#..................#####......##################.....####.......###
##.#####..........###............................#####.......##...................####....#########.##########...####.......####
##.#####...........##..............................##.........###...................###...#########...#######.....####......####
##...####...........#.............................####..............................#####.#######.....########...#####....#.####
##.....##...................##.....................##..................###...........####..######......########..##########.####
#......###...................##...................####...............#########.......#####.######.......###################.####
#.......##..................##...................######..............##########......###....#####........##################.####
##.......##.................####.................######............#############.....###....####...........################.####
###.....##................#.####...............########............####.....###......###.....###..................#########.####
#####.#.##..............###.######.............#######............####...............###....###.....................#....##.####
#########..............####.#######.........##########.............###...............####...#.............................#.####
##########...........######.#########.......#########......###.....###................###.####...........................##.####
#########...........#######.#########........########................#................#######...##.......................##.####
##########........#####.###.########.........########................#.................############.....................###.####
##########........#####.###.#####..............######..................................######..####......................##.####
#########.#.....#######.#....###...............#####....................................###...#####......................##.####
######........#########.##....#.................#.#........#.......#..........###.......###.....##.................#.....##.####
####..........#########.##.....#...#.......##..............###...####.......#######..............................#####.####.####
####............#######.##.....######......###...........#####..####......###########.###.........................#########.####
##.................####.####.#########.....####..........###########.....##############............................########...##
###..................##.##############......####.......#############....################.............................######...##
###.#.#..............##.##############.....######.....###############..##################.............................#####...##
#########.............#.###############....#######.#.####################################..............###...........###########
###############.....###.###############.###################################################.......#.#.##########################
################################################################################################################################
