################################################################################################################################
################################################################################################################################
################################################################################################################################
################################################################################################################################
################################################################################################################################
################################################################################################################################
################################################################################################################################
################################################################################################################################
################################################################################################################################
##################################################################################################.#############################
###############################################################################################.......##########################
##############################################################################################.........#########################
#############################################################################################...........########################
############################################################################################.............#######################
############################################################################################.............#######################
############################################################################################.............#######################
###########################################################################################...............######################
############################################################################################.............#################.....#
############################################################################################.............#######################
############################################################################################.............#######################
#############################################################################################...........########################
##############################################################################################.........#########################
###############################################################################################.......##########################
##################################################################################################.#############################
################################################################################################################################
################################################################################################################################
################################################################################################################################
################################################################################################################################
################################################################################################################################
################################################################################################################################
################################################################################################################################
################################################################################################################################
################################################################################################################################
################################################################################################################################
################################################################################################################################
################################################################################################################################
################################################################################################################################
########################################################################.#######################################################
########################################################################.#######################################################
########################################################################.#######################################################
########################################################################.#######################################################
##############....................######################################.#######################################################
##############....................######################################.#######################################################
##############....................######################################.#######################################################
##############....................######################################.#######################################################
##############....................######################################.#######################################################
##############....................######################################.#######################################################
##############....................######################################.#######################################################
##############....................##############################################################################################
##############....................##############################################################################################
##############....................##############################################################################################
##############....................##############################################################################################
##############....................##############################################################################################
##############....................##############################################################################################
##############....................##############################################################################################
##############....................##############################################################################################
##############....................##############################################################################################
##############....................##############################################################################################
##############....................##############################################################################################
##############....................##############################################################################################
################################################################################################################################
################################################################################################################################
################################################################################################################################
################################################################################################################################
################################################################################################################################
################################################################################################################################
######################################################################.#########################################################
##################################################################.........#####################################################
################################################################.............###################################################
###############################################################...............##################################################
##############################################################.................#################################################
#############################################################...................################################################
#############################################################...................################################################
############################################################.....................###############################################
############################################################.....................###############################################
############################################################.....................###############################################
############################################################.....................###############################################
###########################################################.......................##############################################
############################################################.....................###############################################
############################################################.....................###############################################
############################################################.....................###############################################
############################################################.....................###############################################
############################################################....................################################################
############################################################....................################################################
############################################################.#.................#################################################
############################################################.##...............##################################################
############################################################.###.............###################################################
############################################################.#####.........#####################################################
############################################################.#########.#########################################################
################################################################################################################################
################################################################################################################################
################################################################################################################################
###.............################################################################################################################
###.............################################################################################################################
###.............################################################################################################################
###.............################################################################################################################
###.............################################################################################################################
###..............................###############################################################################################
###..............................###############################################################################################
###..............................###############################################################################################
###............................E.###############################################################################################
###..............................###############################################################################################
##############...................###############################################################################################
##############...................###############################################################################################
##############...................###############################################################################################
##############...................###############################################################################################
##############...................###############################################################################################
##############...................###############################################################################################
##############...................###############################################################################################
##############...................###############################################################################################
##############...................###############################################################################################
##############.........S.........###############################################################################################
##############...................###############################################################################################
##############...................###############################################################################################
##############...................###############################################################################################
##############...................###############################################################################################
################################################################################################################################
################################################################################################################################
################################################################################################################################
################################################################################################################################
################################################################################################################################
################################################################################################################################
################################################################################################################################
################################################################################################################################
################################################################################################################################
################################################################################################################################
################################################################################################################################
################################################################################################################################
