################################################################################################################################
#####.#######.#.#.#.###.#.#.#.##########.#.#.#...................#.#.............................#.#########......##....########
###...######.....................#.##................................................................#####................#...##
###.....###..........................................................................................#####.....................#
##......##.............................................................................................##......................#
##.....................................................................................................###.....................#
##.............................................................................................................................#
##.............................................................................................................................#
##..................##.........................................................................................................#
##.................#####.......................................................................................................#
##.................#####.....................................#.................................................................#
##................#####.....................................##.................................................................#
##.................##......................................####................................................................#
####.......................................................###.................................................................#
###.......................................................#####................................................................#
####.......................................................####................................................................#
##.........................................................####................................................................#
###.........................................................####...........###.................................................#
###.........................................................####..........#####................................................#
####..........................................................#...........#####................................................#
####...........................................................................................................................#
####...........................................................................................................................#
###............................................................................................................................#
###............................................................................................................................#
###............................................................................................................................#
##.............................................................................................................................#
##.......................##......................................###...........................................................#
##......................###.....................................#####....................................................##....#
#........................##....................................######.....................................................#....#
##.......................#.................................##########..........................................................#
#..........................................................#########...........................................................#
##.............................#...........##...............###................................................................#
#.............................###..........#..................................................................................##
##.............................##.........###..................................................................................#
##..............................#.........##...................................................................................#
##........................................####.................................................................................#
##.......................................#####.................................................................................#
##.......................................######................................................................................#
###.......................................####..............#..................................................................#
####......................................####............###..................................................................#
#####......................................##............####..................................................................#
#####......................................##............###..................................................................##
####.................................#.#.###..................................................................................##
###..................................########.................................................................................##
##...................................#######..................................................................................##
##.....................................######.................................................................................##
#........................................####................................................................................###
##........................................####...............................................................................###
#...........................................#................................................................................###
##...........................................................................................................................###
#.....S......................................................................................................................###
##......................#............................................................................#........................##
#......................##....................................................#.....................###........................##
##...........................................................................##....................###........................##
##.................................................................................................#..........................##
##............................................................................................................................##
###...........................................................................................................................##
##.............................................................................................................................#
##............................................................................................................................##
##.............................................................................................................................#
##............................................................................................................................##
##.............................................................................................................................#
##......##....................................................................................................................##
##......####..................................................................................................................##
###....####..................................................................................................................###
######.......................................................................................................................###
######..................................................................#...................................................####
#####..................................................................###.......................E...........................###
####....................................................................##...................................................###
####..........................................................................................................................##
##.............................................................................................................................#
##............................................................................................................................##
#..............................................................................................................................#
#..............................................................................................................................#
#.................................#............................................................................................#
#................................##............................................................................................#
##...............................#.............................................................................................#
##.............................................................................................................................#
##............................................####..............#.............................................................##
#............................................####..............#####.........................................................###
##............................................###.............#######.......................................................####
##......................##....................................########.....................................................#####
###....................###...................................####.####.......................................................###
####....................#....................................##....####......................................................###
####................................................................###........................................................#
#####................................................................##........................................................#
##.............................................................................................................................#
##.............................................................................................................................#
#.......................................................###....................................................................#
#.......................................................##.....................................................................#
#.......................................................#.#...................................................................##
#.......................................................................##.....................................................#
#.......................................................................###....................................................#
#..............................................................................................................................#
#..............................................................................................................................#
##.............................................................................................................................#
##.............................................................................................................................#
##...................#.........................................................................................................#
##...................###...............................................###.....................................................#
##....................##................................................##.....................................................#
##.......................................................................###...................................................#
##.........................................................................................#...................................#
###......................................................................................###...................................#
##......................................................................................####...................................#
###....................................................................................#####...................................#
##.....................................................................................#####...................................#
##.....................................................................................#.##....................................#
##....................#........................................................................................................#
#....................###...........................................................###.........................................#
##....................#............................................................#...........................................#
#...................................#.........................................................................................##
##..................................###.......................................................................................##
#...................................###.......................................................................................##
##....................................#.......................................................................................##
#.............................................................................................................................##
##............................................................................................................................##
##.................................................................................#...........................................#
###...............................................................................##...........................................#
###...............................................................................###..........................................#
###..............................................................................###...........................................#
###.............................................................#.#.#.#.#........###.....................................##....#
####..........................................................###########........###......................................##...#
###....................######................................############.......###.......................................##...#
####.................########................................#######.#..........####......................................######
###..................#######.................................#######............####......................................######
#####..........#############................................#######...........########....................................######
#############################.#.#.#.#.#.#...................#########.........##########......#.#........#####...........#######
################################################################################################################################
