################################################################################################################################
###......#####.#########.#.#.#.####.#.#.#...........#.##########.#...........#####.......########......#.#.#####################
###........#.....######..................................#####............................#####...............######.#.#.#...###
#................#####.....................................#...............................####.................##............##
#................####......................................................................##.................................##
#................###.......................................................................##.................................##
#.............................................................................................................................##
#..............................................................................................................................#
#..............................................................................................................................#
#..................................................................S...........................................................#
##.............................................................................................................................#
#...................................................................................#..........................................#
##..................................................................................##.........................................#
#.........................................#........................................###.........................................#
##........................................##........................................##.........................................#
#..............................................................................................................................#
##.............................................................................................................................#
#..............................................................................................................................#
##.............................................................................................................................#
##.............................................................................................................................#
###............................................................................................................................#
###............................................................................................................................#
####...........................................................................................................................#
###........................................................................................................#...................#
###........................................................................................................###.................#
##.........................................................................................................####................#
##..........................................................................................................####...............#
##...........................................................................................................###...............#
##..........##................................................................................................................##
##..........##.................................................................................................................#
#..............................................................................................................................#
#..............................................................................................................................#
#...................................................................................................#..........................#
#...................................................................................................##.........................#
#......................................................................................###..........##.........................#
##....................................................................................#####..........#.........................#
##.#...................................................................................####...................................##
####..........................................................................................................................##
####.........................................................................................................................###
###..........................................................................................................................###
##...........................................................................................................................###
###............................................................................................................................#
###...........................................................................................................................##
###................................................................................................#...........................#
####...............................................................................................##.........................##
####................................................................................................###........................#
#####.................................................................................................#.......................##
####...........................................................................................................................#
###................................###........................................................................................##
###.................................##........................................................................................##
#.............................................................................................................................##
#.............................................................................................................................##
#.............................................................................................................................##
#.............................................................................................................................##
#..............................................................................................................................#
#.............................................................................................................................##
#..............................................................................................................................#
##............................................................................................................................##
##.............................................................................................................................#
##............................................................................................................................##
##............................................................................................................................##
##............................................................................................................................##
##............................................................................................................................##
###...........................................................................................................................##
#####.........................................................................................................................##
#####.........................................................................................................................##
####..........................................................................................................................##
###...........................................................................................................................##
#..................................................................................................................##........###
##................................................................................................................###........###
#......................................................................#..........................................###.......####
#.....................................................................##..........................................##.........###
#..................................................................................................................#........####
#...........................................................................................................................####
#...........................................................................................................................####
#............................................................................................................................###
#.............................................................................................................................##
#.................................................................................##...........................................#
#..................................................................................##..........................................#
##.................................................................................##..........................................#
##..................................................................................#..........................................#
###...........................................................................................................................##
###............................................................................................................................#
####..........................................................................................................................##
###............................................................................................................................#
###...........................................................................................................................##
##............................................................................................................................##
#.......................................................................................................................####.###
#....................................................................................................................######...##
#....................................................................................................................#####....##
#.....................................................................................................................##......##
#..............................................................................................................................#
#..............................................................................................................................#
#..............................................................................................................................#
#...........#..................................................................................................................#
#.........####...........................................................E.....................................................#
#.........####.................................................................................................................#
#.......######.................................................................................................................#
#.......##.#...................................................................................................................#
#..............................................................................................................................#
#..............................................................................................................................#
#..................#...........................................................................................................#
##................###..........................................................................................................#
#..................#...........................................................................................................#
##.............................................................................................................................#
#..............................................................................................................................#
##.............................................................................................................................#
##.................................................................................................##..........................#
###................................................................................................#...........................#
###............................................................................................................................#
####...........................................................................................................................#
####...........................................................................................................................#
####...........................................................................................................................#
####...........................................................................................................................#
#####..........................................................................................................................#
####...........................................................................................................................#
#####..........................................................................................................................#
#####..........................................................................................................................#
####..................##......................................................................................................##
####.................###......................................................................................................##
###.................##........................................................................................................##
###...........................................................................................................................##
##................#...........................................................................................................##
##................#................................................................................##.........................##
##..............####...............................................................................##.........................##
##.............####.........................#####.................................................#####......................###
###..........########...............#.#.###########.#.#...................#.#..................########...........#.#####....###
################################################################################################################################
