################################################################################################################################
#####################################################################...#####....###############################################
######...#########...######...######.####..######..#################.....###......##############...#############################
#####.......#####.....####.....####...##....####....###############......###.......############......############...############
#####........####......##......####...##.....###.........##########.....###........############.......##########.....##....#####
######.##....####..............####...##.....###..........#########.....##.........############........###..................####
#########....####...............##..........####..........########......##..........############............................####
#########...#####..........................####.........................##..........##########..............................####
########....######.........................####........................####........############.............................####
#######......######.......................######......................#####.......############................##......###..#####
######.......#####........###............###########..................#####........#########.###..........#######....###########
####.........###.........####...........##############.....#..........#####............###....###........########....###########
###.........####........#####.........######################...........####...................#####......#######......##########
###.........####.......#####.........#######.....##########............###....................#####.......##..........##########
###.........#####......####.........########......########.............###....................#####...................##########
###.........#####.......###..........##########...########............####....................####.....................#########
###...........##........###...........#########...#######.............####.....................##......................#########
###....................#####...........########...#####................##.............###...............................##..####
###.............############............#####......###.................................#.....................................###
####............############.............##.........##....##.................................................................###
####............############...##...................###..####................................................###.............###
####.............##########..#####..................#########...............................................####.............###
#####..................###...#####..................#########...............................................###..............###
#####........................####...................#########..................##...........................##..............####
#####........................###....................########..................####..##......................................####
#####.........................##....................#######.....#######......##########................###..................####
######........................###....................######....#########.....##########.............#######..................###
######........................#####.....................##.....###########..##########.............###########...............###
######.........................#####............................###############...##...........##########..####......####....###
#####.................#.........####.................##...........############................##########....####...#######...###
#####.......#........###.........###................####...........###########.........##....##########.....#############...####
####.......###........#..........###.............########...........###########........##....########.......#########.......####
##..........#....................####...........#########...........####..#####........##.....######.........#######........####
#.................................###...........##########..........###....###.........##....................######........#####
#.................................####......#....##########....#.......................###....................#####.......######
##......................##........#####....###.....##############.....................####......................###......#######
######.................####.......#####.....#.......#############.....................####.......................###....########
#######................####........###...............############..........####......####...###...................###..#########
###########............####..........................###########.........######......####...####........###.......##############
############...........####...........................##########........#######......####...######.....#####......##############
###.....####............##...................................####.....#######.........##....#########..######.....###..#########
##.......##...................................................##############.................#########..######..........##...###
##......................................##......................###########..................#########...#######..............##
##..............###.....................##........................########..............S....###..#####.########..............##
##...........######.................................................#####..........##.............##########..................##
##.........########..................................................####.........####............##########.................###
##........#########..................................................####..........#######........##########.................###
##.......#########....................................................##...........#######........###########................###
##.......#########..................................................................#####........#######...#.................###
##......#########...................................................................####.........######......................###
##......#########....................................................................##..........######......................###
###......##..###................................................................###.............########.....................###
###....................................................######................######............#########.....................###
###...................................................########.............########............########.......................##
###...................................................#########..........####...####...........#####..........................##
###..................................................##########.........####.....####..........####...........................##
####................................................##########.........####.......###..........####...........................##
####................................................########..........####........###.........#####............................#
####...#####.....####............##..................######........######.........###.........####........###..................#
###...######....######..........####.................#####........######..........###.....................####.....##.........##
###...#####.....######..........#####...............######........######.................................#####....####.......###
###...####.......####...........######............########........#####...............................#########..#####.....#####
###....##........................######..........#########.........##......#.........................##################...######
###.........###.....................##.....##....#########................###.......................############################
###........####.............................#...##########.................###......................###############..###########
##.........####................................###########.................###......###............####...#####...........######
#...........##..................................#..######..................####....######..........###.....#######...........###
#..................................................#####...................#####...########........###......######............##
##..............................................#######....................#################........###.......####.............#
######.........................................#######.....................##########..######.......###........####............#
#######.......................................#######......##...............########......##........###.........#####..........#
######....................................###########.....####...............#######.............................####.....##..##
#####....................................###########......####..................#####............................####....#######
#####...................................###########.......####...................####............................###.....#######
####.........................##........###########........####.............#.....####....................................#######
###........................#####......###########.........####......##....###....###....................................########
###.....###...............#######....####.................#####....####..####....###...................................#########
###.....###...##..........##############.........##.......##################......##..................................##########
###.....##...####.........#############.........####......##################.........................................###########
###..........########......#######..............####.........################.......................................############
###..........########......#####...............####.............###..#########.....................................#############
###...........##..##.......####................####...................########.........##..........................#############
###.....................#######................###....................#######.........####..........................###.....####
###....................########.......###.......#......................#####..........####..............#....................###
##.....................#########.....#####.............................#####..........###.............####....................##
##.......##....####.....#########....######....................#..##...#####...........##............######...................##
##......####..######....##########..########..................######....###..........................#######..................##
##......#############..########################................#####..................................#######.................##
##.......#######################################......................................................#######.................##
##.......########..#############################......................######...........................#####..................##
###.......######....#####################..#####..................###########....###.........................................###
####.......####......####################....##..................############....###.........................................###
#####.......##..........##################......................#############................................................###
#####....................##################........##...........########..##..........###....................................###
####.....................##################.......#####.........#######..............#####....................................##
####....................##################......#########........#######............#####.....................................##
####.............##..#################........############.......##########........#####.......................##.............##
#######..........####################........######..#####.......##########.........###........................#.............###
########..........###################........#####....###........#########...................................................###
########...................##########.........####...............#########..................##..............................####
########...................###########..........##................#########..#####.........####............##...............####
########..................####.....####..........###...............################.......#####...........####.E...##........###
########..................###.......####.........##########........#################......######..........####....###.........##
#########..........###....###.......####.........###########.......#################......######...........###...####.........##
#########.........####....##........###..........############.....#######....#######.....#######............##...####.........##
##########.......####...............###...........####################...........##......#######......###..###########.......###
##########......####...............####...........####.....##########....................#######.....#################...#...###
##########......####..............####............####......#######.......................#####.....##################...##..###
##########......####..............####............####......######.................................########...#######....#....##
###...###...........##.............##..............##......####.....................................######.....######.........##
###...###...........###....................................###....................########............###.......######.......###
####...###..#.......###..........................................................############....................#####......####
#####...######......##...........................................................#############....................####......####
#####....#####.....####..###.....................................................#############....##..............#####......###
####.....####......##########.....................................................############...####.............#####.......##
###.......##.......######..#.......###................##..........................##########....#####..............#####......##
##.................#####.......########..............####..........##..............#######......######.......###....######....##
##.................####........#######...............####.........####..............######......#######....######...#######...##
##......##........#####........###...................###..........#####..............#####.......##..############...#######...##
##.....####.......#####..............................###....#.....####.........#......###.............###########...######....##
#......####........###..............................#####..###.....##.........###.....###..............##########...#####.....##
#.......##.....................###.................###########.................###....####.................#####.....##.......##
#...........................#######..........##....##########...................###..#####..................###...............##
#..........................#########........####....#########...................##########..................###...............##
##....................##############.......######...#########..................###########..................###.........##....##
###..###..........###################.....####################................#############................#####......#####..###
#############....##############################################..########....#######################...##########...############
################################################################################################################################
