################################################################################################################################
##########......############################..##########################.....###..############..################################
#########........#####.....#####....#######....#############....#######............##########.....######..###..#################
#########....................##......#####......############........###.............########.......###..........################
##########............................####.......#############.......##..............##..##......................###############
##########.............................##........##############...................................................#########.####
##########.......................................#####....#####....................................................##..###...###
##########......................................####........##..........................................................##...###
##########......................................#.....................................S..............###................##...###
###########..............................#...........#####...........................................####..............####...##
############............................###.........######.........................##................#####.............####...##
############.............##.......#......#..........######........................######.............#####.............####...##
########.##.............####.....###................#####.........................#######.............###..............###....##
#######.................####....####................####...........................######.....................................##
######...................##...######.................###............................####......................................##
#####........................########................####..................##...........................####.........##......###
####.........................#########..............#####.................####..........................######......####.....###
####.....##......#...........#########.............######.............########..........................#######.....####.....###
#####...####....###..........########.............#######.............########............................#####....#####.....###
############....###...........#######............#######..............#######..............................####....#####......##
###########.....##............#######...........#####................#######................................##......###........#
#####..........###...........#######............####......###........######....................................................#
####...........###...###....######...............###......###........#####.....................................................#
####..........###########...###...........##...............###........####....................................................##
####.........############....#...........####...............###........###..................#.........###.....................##
####........############................######..............###........###.....###.........#####.....#####....................##
###........#############..............########...............#...............#####.........######....#####...................###
###........#######...####..........############......#......................######.........#####......###...................####
###.........####......####........#############.....###.....................#####..........####.............................####
####...................######.....##############...####........##..........#####...........###......................##......####
#####..................########..######################.......####.......######............###.....................####......###
#####...................##############..###############.......####....########..............##.....##..............####......###
#####....................##..########....####..#########......####...##########..............##...####..............##......####
#####.........................#######....####...#########.....####...##########..............###..####......................####
######........................####......#####....########.....###.....###########............###...##.............#.........####
##.###........###..............##.......######.......####.....##......##########..#...........##.................###.........###
#.............#####....................########.......##..............#########...##..........##.................###..........##
##............#######.................###########....................##########...###.........###...............####..........##
##...............#####...............#######...###..................###########...#####........#####......##...#####..........##
##................####..............#######.....##......###.........###########....#####.......#####.....############........###
##.................##.....###.......######.............#####.......############....#####.......#####.....############..........#
##.......................###########...................#####......##############..######......#####......###########..........##
###......................###########..................#####......######################......#####.......##########.....##....##
######..................###########...................###........######################.....######........####.........####..###
######.......##.........##########....................##..........######################....######.........##..........#########
###.##......###..........#######......................##...........##########.......#####...######.....................#########
##..........###...........#####......................##................#####..........###...#####......................#########
##........................####......................##..................###..................###............................####
##........................####.....................###.....#.................................................................###
##.......................######.....................#....####.................................................................##
##.......................######.........................####.......................................................###..###...##
##........................#####...................#....####........................................................#########..##
###.......................####...................#########.................#.......................................#########..##
######....................####....###.............########.................##..........................#####.............###...#
#######...........#.......####..#####..............#######............................................#######.............#....#
#######..........###.....############...............#######..........................................########..................#
######............#.....#############...............#########.......................................########...................#
######...................############...............##########......................................#######......######........#
#####...............................................##########.......................................######.....########......##
#####...............................................#########..........................##.............######.....######......###
####................................................######......##....................####.............#####......####......####
###.......................##........................#####......####...................####.........................##.......####
##.......................########...................#####......#####..................###..........................##.......####
##......................##########...................###.......#######........##.....###..........................####.......###
###....................###########..............................########.....####.....#...........##....##.......######.......##
###....................##########.................................#######....######..............####..####......#####........##
###.......###..........#########.....................................#####..########............###########......####.........##
###......#####.........#########......................................##############.............##########..................###
###......#####.........#########...##.................................###############.................#####..................###
##........###.........#########....##.............#..............#...################..................####.................####
#................#....#####......................###..###.......##...#########..####....................###...............######
#...............##.....##.........................#..######.....##....#######....##.....................###..............#######
##.....######................###.....................#######....##......#####...........................##...............#######
##....########..............#####..........##........#######....###......####.................##................##........######
##....#######...............######........####........#######..####.......####......###......####..............####.......######
##....######................######...#########.........############........####....###.......#####.............####.......######
###...#####..........##.....#######.##########.........############.........####.............#####.............####.......######
###...#####.........###....####################.........##########.........#####............#####...............##.......#######
###....###..........###....#####################............#####.........#######.....##..######..........................######
##.........................###########....#######.........................#######....#########..............................####
##..........................#########......######...........................######...########...........##....##.............###
###.........................########........#####............................#####....######..........#####..####............###
####....................#######..............####............................#####..................#############...........####
#####..................#######...............####............................#####.................#############............####
######.................#######...#...........####.............................###..................##..#####.................###
######.................############...........##...................................................#....###..................###
######.................############........................................................###....##.....###..................##
##.............####....###########.....##............##....................................###...###......###.................##
#.............######....########......####...........##.....................................##..E###.......#........##..##....##
#.............######.....####........#####...........##............#........................#....................##########...##
#.............######.....###.........######.........####..........###...###................##...................###########...##
##.....##.....######.....###.........######.........#######.......####..#####.............###..................############...##
###....#.....######......###.........#####..............####......####....####............###.................#############...##
####........#######......####........####................###......####.....##............####...........#.....#############...##
######......#######......#########..####..................##.....####....................###...........###.....##....######...##
#######.....######.......##############..........................###.....................##............###............####....##
########...######........##############...........................#....###........#.....................#..............###...###
#################........##############...............................#####......###...................................###...###
#################........#####.......##....###............##..........######....####...................................#########
##################.......#####.............####..........####........########..####.......##...........................#########
###....###..#######......#####..............###..........#####.......#############.......###............................########
##...........######.....#####................#........#########......############........###.................###...........#####
##............#####.....####.......#.................##########.......###########........##..................####...........####
#..............###.....#####......###...............##########.............######........##...................#####.........####
#......................#####......###..............#########................#####........##...................######........####
#.....................######......................######....................#####.......###....##.............##.###.........###
##...................######......................######....................#####.......####...####............##.##...........##
##...................###........................#######........##.........####........####....#######........###.#....##......##
##...........##......##........####.............#######.......####........###.........####....##########.....###.#...######...##
#...........####..............#####............#########......####.........#...........##....############.....##.#...######....#
#...........###...............#####............##########......##............................###########.......#.....######....#
#..............................###.............###########...................................##..######.............####.......#
##............................................############........................................#####.............####.......#
###....................##....................############.......##.....................##..........####..............###.......#
###...................####...............##############........###....................####........######.......#......#####....#
###...................####...............#############................................####.....##########.....##.......#####..##
##...............##..####.................######...##................................#####....############....##.......#####..##
##...............#######...........................##..................###.........######.....############....##.......####...##
###..............#####............##..............##..................#####.......#######.....############...##.......#####...##
######...........####............####.............##..................#####.......########....###########.............#####...##
########.........###.............#####...........####.................######.......########...#########................#####.###
###########.......................#####.........#####..................########........####...#######....................#######
############........................##........#######...................########........##.....#####......................######
#############................................#######.....................#########.............####........................#####
##############..............................########....##................###########.........#####....##..................#####
##################........######..####....###########..######.............#############..##..#######..####...........##...######
####################...##############################################....#######################################################
################################################################################################################################
