################################################################################################################################
###.................#.#.#.#..############.#.#.#.#####..###.#....#########............#.............#.#.#.########.#.#.#.#.######
#............................#####..####.........####.............#####..................................#.####...........#.#.##
#.............................#.#..#...#........###..............######....................................##.................##
#...................................#............##...............####.........................................................#
#..................................#............###..............#..#..........................................................#
#................................##..............##............................................................................#
#..................................#...............#...........................................................................#
##..............##.............................................................................................................#
#..............#...............................................................................................................#
##..............##.............................................................................................................#
##............#.###............................................................................................................#
###...........#.##.............................................................................................................#
##...........#................................................................................................................##
##.............................................................................................................................#
#.............................................................................................................................##
##............................................................................................................................##
#............................................................................................................................###
##.....##.....................................................................................................................##
####.##..............................................................#..#....................................................###
#####.................................................................##......................................................##
####................................................................######..................................................####
###..................................................................####................................................#.#####
#.....................................................................##.#..............................................#.######
##........................................................................................................................#.####
#.............................................................................................................................##
##............................................................................................................................##
#..............................................................................................................................#
##....................................................................................................#.......................##
#..............................................................................................................................#
##.............................................................................................................................#
#..............................................................................................................................#
#.............................#................................................................................................#
#............................###........#.....................................................................................##
###...........................#..........#.....................................................................................#
#............................#............#....................................................................................#
##.................S...........................................................................................................#
#..............................................................................................................................#
##.............................................................................................................................#
#..............................................................................................................................#
##.........#................................................................................................................#.##
#.......#.#...............#...................................#............................................................#####
##.......#................#...................................#.#......................................#..................######
#........#................#...................................#.#..................................#.######................#.###
##.......#...................................................#.#..................................#.#####....................###
#...................................................................................................#.#........................#
##................................................................................................##...........................#
#..............................................................................................................................#
##.............................................................................................................................#
#............................................................................................................................###
##...........................................................................................................................###
#..........................................................................................................................#####
##........................................................................................................................#.####
###.......................................................................................................................#.####
##..........................................................................................................................#.##
###...........................................................................................................................##
##.............................................................................................................................#
#.............................................................................................................................##
##.............................................................................................................................#
#.............................................................................................................................##
##.............................................................................................................................#
#..............................................................................................................................#
#..............................................................................................................................#
##.............................................................................................................................#
##............................................................................................................................##
##.............................................................................................................................#
#..............................................................................................................................#
##.........#.................................#.................................................................................#
##.#......##................................#####..............................................................................#
###.........#..............................####................................................................................#
#.#......###.#.................................#...............................................................................#
#..........#..................................................................................................................##
#..............................................................................................................................#
#.............................................................................................................................##
#............................................................................................................................###
#...........................................................................................................................#.##
#.............................................................................................................................##
#.......................#....................................................................................................###
#........................#....................................................................................................##
#.......................###.................................................................................................####
#........................#............................................................E.......................................##
#......................#....................................................................................................####
#.....................####...................................................................................................###
#....................####....................................................................................................###
##....................#.#.....................................................................................................##
##......................#....................................................................................................###
##............................................................................................................................##
#............................................................................................................................###
#.....................................................................................................................#.......##
#................................#..................................................................................#.#......###
#...............................#....................#..............................................................###.......##
#................................#.................#.#.............................................................#..........##
#...................................................###...................#...................................................##
#.................................................#.##..................#.#...................................................##
#..................................................#.....................##.#.................................................##
#...................................................#..........#........#..#..................................................##
#...............................................................#........#.....................................................#
#..............................................................#...............................................................#
#..............................................................................................................................#
#..............................................................................................................................#
##.............................................................................................................................#
#..............................#...............................................................................................#
#.............................#.#..............................................................................................#
#..............................................................................................................................#
#................................#.............................................................................................#
#................................#.............................................................................................#
#...............................#....................................#.........................................................#
##............................#.....................................#..#.......................................................#
#...........................#..#.....................................####.....................................................##
###.................................................................#######.........#..........................................#
##.................................................................#.######.#........##........................................#
###..................................................................#######.........#........................................##
###.................................................................#########........#.......................................###
##....................................................................######.........#.......................................###
###......................................................................##...................................................##
##.....................#................................................#.....................................................##
##....................#..................................................#...................................................###
#.....................#......................................................................................................###
#......................#.......................................................................................................#
##............................................................................................................................##
###............................................................................................................................#
#####..........................................................................................................................#
#####..........................................................................................................................#
###.#...................#..............................................#.......................................................#
#.......................###....................#.....................####.....................................................##
##.....................#####.............#....#..#........##.#.....#.#####....................................................##
##.#.#.#.#.............######..#.#.#...#.#.#.#####.#.....######.###########......#.#...........#######.#.#.#.#......#.#.....####
################################################################################################################################
