################################################################################################################################
#######........................................................................................############.#.#.################
######....####.............######.......########......######..##########......####........####.####...###........###########.###
####.......#................###...........#####........####....########........###.........###.##..................#######...###
######.....................................###.........###.....#######.....................###..#.................#######.....##
###..........................................#.#.......####.....#####.......................#.....................######......##
####...........................................#......###.......#####............#...........................##.#######.......##
##.............................................##.....###.........####.........#####.......................############.......##
##.............................................##....##...........####.#.......#####.....................##############.......##
#....................###..###..................###.................#######...#########...................##############........#
##....................###..##.........###......###................############.#.#####..................###############.......##
#......###............................####.....###.................###########.....####.................##############.........#
##.....###.......###...................#####.#####.................##########.......####................#.##########..........##
##...#####.......###....................#########...................#########........###....................#######............#
#########.......#####....................########...................#########.........####.................#######.............#
#########.......#####......................#####.....................#######............##..................#######............#
#######........######.......................####.....................##....#...............................#######.............#
#######.........##.........................###........................#....................................#######.............#
####.#.........###.......###...............###.............................................................#######.............#
####..........##........#######..........####......##...........#...........##..............................#####..............#
##...........###......#########..........####......#............##.........###..................##..........###...............##
###.....##............########..........####.......#............##.........#####...............####...........................##
##......####........#####...............####.....................###.........####..............####...........................##
####....####........#####...............####.....................###.........#####.............####..........................###
####....#####.......###..................#####..........###.......####.........##...............##.....##.....................##
######.######.......#.#....................####..........###.......####........##......................##....................###
#############............###.................###........####........###...............................####....................##
##############..........#####............................##..........##...............................####...................###
##############...........####.........................................#......................................................###
##############...........####..............................................................................................#####
######.......#............#...............................................................................................######
#####...................................................................................................................########
#####..............................................#####...............................###..............................########
#####.............................................######.......................#####....##.............................#########
######.....#.....................................#######......................######...####............................#########
######...###......................................####........................######...######...........................########
####.....###..............##..................................................#####....######.............................#.####
###......#...............###................#...............#..................###......######................................##
##...................###..##...............####...........###.............................####.##............................###
##.................#####...................###..........####.......#........................##.##.............................##
#.................#####....................##...........#####.....####......................##.##.......................#.#.####
##................####..................................####.......####.....................##.##....................###########
###.............####...................................######.......###..............##............................#############
###.#.........####.....................................#####.........###.......###.###.............................#############
#####........#####.......................#.......############..................#######.............................#############
#####........####.......................####..S..#.#########...................#######....###........................###########
###...........####.......................##.........########....................#####.....###.......................#########.##
###............##.....................................#.####...................#####.....#####.......................######...##
##........................................................#...............................####......................#####....###
##.....#.........................................#........#.#.##..........................####................................##
##....##...............#.......................#####........####...................#.......###....................#.#.........##
##...................#####...................#######.......####....................##......###....................##...........#
#....................#####.................########........####....................####.....#....................####.........##
##...............######.#.................#######...........#.......................###.....#............###......###..........#
#...............###........................####.....................................#####.#.#............####.....###........###
##...............###.....................######........................#.#.###........#######..........#######...............###
##.....................................########.........................#######.........#####..........#######..............####
##...................................############................##......######.......................########.............#####
###....................................#############.............###.......####.......................###.####.............#####
###.........................##.........##############............#...........#........................###...###.............####
##..........................###........##############.................................................#.....#...............####
##.........................####.........#######.#.#....................................................#.#...................###
#..............#...........#####..........###..........................................................#####.................###
#..............###.........####.................................#.................####.................####...................##
#..............###..........####........................#......###...............#######...............#####..................##
#...............###.........####.......................####.##.##...............########.................###...................#
###..............##..........###........................######.##...............####.#.###.........#.....##...................##
###.............####.......#####........................######.#.................###.....##.....######...##....................#
####............######.....####.............#...........######...................#.......####..###########................##..##
####...........#######.#...####...........#####.#.......######...................#.#......####.###########................##.###
#####..........########.....##............#######......#####.....................###.....#####.##########.................######
########........#######......###..........######........##....................######...#.#####.###########.................#####
#########.....#.#######........###.........#####............................######.#...#######.##########...................####
##########....########.................#....###............................######......#.#####...#########...................###
##########...#########.................#.....###...........................####............##...##########...................###
#########.....#######..................##....###...........................................###..##########...................###
#########........##...........................####.........................................###.##########...................####
#########............................................###.....................................##########.....................####
##.#####............................................#####......................................#######.....................#####
##...####.......#....................................##...........................#............########...................######
#...............###...................................#...#......................##.............#####.#...................######
##............####........................................###.###...............................###.#.#..................#######
#.............####.......................................#########................................#.....................###.####
##...........###.........................................####...###.....................##..............................#.....##
#............................####.......................#####.....................#.....##........#..........................###
##...........................###...###...................###......................###..####.......#.#.......###..............###
###.........................####....##..........................................###########.......###......####..............###
####........##..............####.....#........................................###.##########.......##......####.............####
####........###............####.............................................#####.##########................#...............####
#####......#####.#........####..............................................###....###.#.#........................#........#####
####.......#######........####..............................................##.....#.............................###.......#####
#####......######........####........................##..........................................................####.....######
#####....................###.........................##...........................................................##......######
######................#.###.....###................................................................#..............###...###...##
#######...............#........#####..................................................##...........#.....###......###.#.####..##
########..............##......######................................................###......##....#.#.............########....#
#######..............###......########.......###............................................##.....#.#...........##########...##
#######...............##.....####.#.##......####...................................................##.........###########.....##
#####................###.....####...........#####.................................................####........#####...........##
####.................###......#...............#..................................................####........####.............##
###.................#####.......................................................E................#####......###...............##
##..................#####............................................#...........................######.....###..............###
##................#######............................................#....................###....#######....#...............####
##................########......................................................................###....#.....#.............#####
#................#########...........#........#..........................#####..................#..........###............######
##.....##........########.....................#...........................####.............................####...........######
##.#.#####.......#.#.#.###....####............#.............................#.............................#####..........#######
######.#....................######....................................................#...................#####..........#######
#####...................###.#####.......###..........##..............................#####...............#####..........########
###.........................#.#.........##..........####...........##...............#######...............####..........########
####............########......#.........###.......#.#####..........###.............#######.................##..........#########
###............########................###.......#######...........###...........######...............###..##.........##########
###............#######..................##.......#######...........####........#.####.................###.............###..#####
###...........#######..................###........######.........#####.........####...............#...#######........###....####
####..........######......#............###.........####.......##.#####..........#................###....####........#####....###
####..........#######....##............###.........#####....######.##............................#####.#####........#####.....##
#####.............#..................######..........#.#...####.................................###########.........####.......#
###.#................................######............#.####..................................##########............##........#
###.#...............................#######..............#..................................#.###..#####.......................#
###.#................................##.#.#...............................................######....###........................#
###.##....................................................................................######...............................#
###.##.....................................................................................#####...............................#
###.###......................................................................................###..............................##
###.#................................................####...............#####................#####........#..................###
#####.#............................................#######.............########...............#######...####................####
#####.#.#.#.#......................####........#.#.##########.#.#.#...#############..........##########.###................#####
###############..........####.#.#########....#.####################.#################.......#################.#.####.#.#.#######
################################################################################################################################
