################################################################################################################################
################################################################################################################################
################################################################################################################################
################################################################################################################################
################################################################################################################################
################################################################################################################################
################################################################################################################################
################################################################################################################################
####################################################..............##############################################################
###############.####################################..............##############################################################
###########.........################################..............##############################################################
#########.............##############################..............##############################################################
########...............#############################..............##############################################################
#######.................############################..............##############################################################
#######.................############################..............##############################################################
######...................###########################..............##############################################################
######...................###########################..............##############################################################
######...................###########################..............##############################################################
######...................###########################..............##############################################################
#####.....................##########################..............##############################################################
######...................###########################..............##############################################################
######...................###########################..............##############################################################
######...................###########################..............##############################################################
######...................#######################################################################################################
#######.................########################################################################################################
#######.................########################################################################################################
########...............#########################################################################################################
#########.............##########################################################################################################
###########.........############################################################################################################
###############.################################################################################################################
################################################################################################################################
################################################################################################################################
################################################################################################################################
################################################################################################################################
################################################################################################################################
################################################################################################################################
################################################################################################################################
################################################################################################################################
################################################################################################################################
################################################################################################################################
################.###############################################################################################################
############.........###########################################################################################################
##########.............#########################################################################################################
#########...............########################################################################################################
########.................#######################################################################################################
#######...................######################################################################################################
#######...................#######################################################################################...........####
######.....................######################################################################################...........####
######.....................######################################################################################...........####
######.....................######################################################################################...........####
######..................................#########################################################################...........####
#####...................................#########################################################################...........####
######..................................#########################################################################...........####
######..................................#########################################################################...........####
######..................................#########################################################################...........####
######.....E............................#########################################################################...........####
#######.................................#########################################################################...........####
#######...................S.............######.##################################################################...........####
########.................#####################.##################################################################...........####
#########...............######################.##################################################################...........####
##########.............#######################.##################################################################...........####
############.........#########################.##################################################################...........####
################.################################################################################################...........####
#################################################################################################################...........####
################################################################################################################################
################################################################################################################################
################################################################################################################################
################################################################################################################################
################################################################################################################################
################################################################################################################################
################################################################################################################################
################################################################################################################################
################################################################################################################################
################################################################################################################################
################################################################################################################################
################################################################################################################################
################################################################################################################################
################################################################################################################################
################################################################################################################################
################################################################################################################################
################################################################################################################################
################################################################################################################################
################################################################################################################################
################################################################################################################################
################################################################################################################################
################################################################################################################################
################################################################################################################################
################################################################################################################################
################################################################################################################################
################################################################################################################################
################################################################################################################################
################################################################################################################################
################################################################################################################################
################################################################################################################################
################################################################################################################################
###################################################################################################################.############
###################################################################################################################.############
###################################################################################################################.############
###################################################################################################################.############
###################################################################################################################.############
###################################################################################################################.############
###################################################################################################################.############
###################################################################################################################.############
###################################################################################################################.############
###################################################################################################################.############
###################################################################################################################.############
###################################################################################################################.############
################################################################################################################################
################################################################################################################################
################################################################################################################################
################################################################################################################################
################################################################################################################################
##############################################################################################################.#################
##############################################################################################################.#################
##############################################################################################################.#################
##############################################################################################################.#################
##############################################################################################################.#################
##############################################################################################################.#################
################################################################################################################################
################################################################################################################################
################################################################################################################################
################################################################################################################################
################################################################################################################################
################################################################################################################################
################################################################################################################################
################################################################################################################################
################################################################################################################################
################################################################################################################################
