################################################################################################################################
################################################################################################################################
####################################################################################################################.........###
####################################################################################################################.........###
####################################################################################################################.........###
##############################################################..................####################################.........###
##############################################################..................####################################.........###
##############################################################..................####################################.........###
##############################################################..................####################################.........###
##############################################################..................####################################.........###
##############################################################..................####################################.........###
##############################################################..................####################################.........###
##############################################################..................####################################.........###
##############################################################..................####################################.........###
##############################################################..................####################################.........###
##############################################################..................####################################.........###
##############################################################..................#.##################################.........###
##############################################################.......................###########################################
##############################################################........................##########################################
##############################################################.........................#########################################
############################################################################...........#########################################
############################################################################...........#########################################
####.######################################################################.............########################################
####.#######################################################################...........#########################################
####.#######################################################################...........#########################################
####.#######################################################################...........#########################################
####.########################################################################.........##########################################
####.#########################################################################.......###########################################
####.############################################################################.##############################################
####.###########################################################################################################################
####.###########################################################################################################################
####.###########################################################################################################################
####.###########################################################################################################################
####.###########################################################################################################################
####.###########################################################################################################################
####.###########################################################################################################################
####.###########################################################################################################################
####.###########################################################################################################################
####.###########################################################################################################################
####.###########################################################################################################################
################################################################################################################################
################################################################################################################################
################################################################################################################################
################################################################################################################################
################################################################################################################################
################################################################################################################################
################################################################################################################################
################################################################################################################################
################################################################################################################################
###################################.############################################################################################
###############################.........########################################################################################
#############################.............######################################################################################
############################...............#####################################################################################
###########################.................####################################################################################
##########################...................###################################################################################
##########################...................###################################################################################
#########################.....................##################################################################################
#########################.....................##################################################################################
#########################.................E...##################################################################################
#########################.....................##################################################################################
########################.......................#################################################################################
#########################.....................##################################################################################
#########################.....................##################################################################################
#########################.....................##################################################################################
#########################.....................##################################################################################
##########################................S..###################################################################################
##########################...................###################################################################################
###########################.................####################################################################################
############################...............#####################################################################################
#############################.............######################################################################################
###############################.........########################################################################################
###################################.############################################################################################
################################################################################################################################
################################################################################################################################
################################################################################################################################
################################################################################################################################
################################################################################################################################
################################################################################################################################
################################################################################################################################
##########.#####################################################################################################################
##########.#####################################################################################################################
##########.#####################################################################################################################
##########.#####################################################################################################################
##########.#####################################################################################################################
##########.#####################################################################################################################
##########.#####################################################################################################################
################################################################################################################################
################################################################################################################################
################################################################################################################################
################################################################################################################################
################################################################################################################################
################################################################################################################################
################################################################################################################################
################################################################################################################################
################################################################################################################################
################################################################################################################################
#########################...................####################################################################################
################################################################################################################################
################################################################################################################################
################################################################################################################################
################################################################################################################################
################################################################################################################################
################################################################################################################################
################################################################################################################################
################################################################################################################################
################################################################################################################################
################################################################################################################################
################################################################################################################################
################################################################################################################################
################################################################################################################################
################################################################################################################################
################################################################################################################################
################################################################################################################################
################################################################################################################################
################################################################################################################################
##########################################################################################################......################
##########################################################################################################......################
##########################################################################################################......################
##########################################################################################################......################
##########################################################################################################......################
##########################################################################################################......################
##########################################################################################################......################
##########################################################################################################......################
##########################################################################################################......################
################################################################################################################################
################################################################################################################################
################################################################################################################################
################################################################################################################################
