################################################################################################################################
###.#.#.#####.#.#####.#.#.#####.......#.#.#####.........####################........#.#.#.######.#..........####################
###.......#.......#.........#.#.............#................#######.........................................#####...###########
##................#.......#.#.................................#####............................................#......####.#####
##........................###..................................###.....................................................#...#####
##........................###...............................................................................................####
##..................................................................................................##......................####
###...........#....................................................................#...............####.....................####
###.........###....................................................................###..............##......................####
###................................................................................###.#....................................####
###......................................#..........................................#####.....................................##
###......................................##.........................................###.#.....................................##
##.......................................###...................................................................................#
##........................................##...............................................................#..................##
#..........................................##..............................................................###.#.###...........#
#..........................................##............................................###................#########..........#
#........................................................................................###.................########..........#
#........................................................................................####..................#.#.#...........#
##.......................................................................................####..................................#
##........................................................................................####.................................#
###.......................................................................................#####................................#
###.........................................................................................###...............................##
###...........................................................................................#........................####.#.##
##.........................................##.........................................................................##########
##.........................................##.........................................................................##########
##........#................................##.........................................................................###.....##
#........##....................................................................................................................#
##.............................................................................................................................#
#..............................................................#...............................................................#
##.........................#.#................................###..............................................................#
#........................#######.............................####..............................................................#
##.......................#######..............................##.........................................................##..###
##......................########...............................#.....................................................#.####.####
##.............#........#######....................................................................................######.....##
##.............###......#######....................................................................................######.....##
##.............###.......#####......................................................................................###........#
##.......................###..................................................................................................##
##.............................................................................................................................#
##.....S......................................................................................................................##
##.............................................................................................##.............................##
##...........................................................................................####.............................##
###..................................................................................##......###.............................###
###.................................................................................###......................................###
##..................................................................................###.....................................####
##.................................................................................###....................................######
##.................................................................................###...................................#######
#..................................................................................##....................................#######
##................................................................................................###....................#######
#................................................................................................#####...................#######
##..............................................................................................######....................######
#...................###..........................................................................####.....................###.##
##..................###...........................................................................##..........................##
##.................####........................................................................................................#
##.................###.......................................................................................................###
##...........................................................................................................................###
##..................................................................................................................#.#......###
##.................................................................................................................####......###
#..................................................................................................................####.......##
##...................................................................................................................##........#
#..................................................##.....................................................###..................#
##..................................................#......................................................##.................##
#...........................................................................................................#.................##
##...........................................................#...............................................................###
#...............##.........................................#####.............................................................###
##..............###........................................######.............................................................##
#..............###..........................................####.........................####.................................##
##.........................................................................................##..................................#
##.........................................................................................###.................................#
##..........................................................................................##..................###............#
##..........................................................................................###...............#######..........#
###..........................................................................................##..............#####.##..........#
###...............###......................................................................................#####..............##
##................####.....................................................................................#####..............##
##................###....................................................................................#####.............#####
##.................####.................................#...............................................#####............#######
##......................................................#................................##..............###............########
##.....................................................##...............................###..............................#######
##....................................................##.................................##.............................########
##..................#.#.............................####.................................................................#######
#.................####...............................##.................................................................########
##..............#####.................................#...................................................................######
#..............####........................................................................................................#####
##.............##...........................................................................................................####
#............................................................................................................................###
#..................................................................................##..........#.......##.....................##
#...................................#..............................................##.........###.......##.....................#
#...................................##....................................#.........#.........###.............................##
#..................................####...................................###..................................................#
#.............##....................##.....................................##.................................................##
#.............###.....##.......................................................................................................#
#............###......##......................................................................................................##
#.............###....###.......................................................................................................#
#.............##.....##........................................................................................................#
#...................###........................................................................................................#
#....................##........................................................................................................#
#...................###........................................................................................................#
#..................####........................................................................................................#
#..................##.......................###................................................................................#
##..........................................####...............................................................................#
###..........................................####........................................#.....................................#
#####.........................................##.........................................#.....................................#
#####...................................................................................##....................................##
###....................................................................................###.....................................#
##...................................................................................#####....................................##
##............................................#....................................#######.....................................#
##............................................##.....................................#####....................................##
##.....................................................................................#............................##........##
##................................########...........................................................E...............##......###
##................................#########..........................................................................##......###
##................................#########.............##.#..........................................................##.....###
####...............................#.#.####............#######........................................................##......##
####.....................................#...............#.#.#.........................................................#.....###
#####........................................................#................................................................##
###...........................................................................................................................##
#......#.......................................................#...............................................................#
##.....##.......................................................#.............................................................##
#................##............................................##..............................................................#
##..............##.............................................##.............................................................##
##.............###.............................................................................................................#
##...................................................................................................................##.......##
###..................................................................................................................##........#
###...........................................................................................................................##
###.....................###.............................##.....................................................................#
####....................###..............................#....................................................................##
####..................#####..............................##.................###.................##...................###......##
#####...............#######......#.#....................###......####.....########...........#######...............######...####
############################...##############.#.##......######.#.###################.......############.#.##.#.#.##########.####
################################################################################################################################
