################################################################################################################################
####.........................................................................#############################################..####
####.############..........#################...################....................###....##.......###############...####....###
####...#######......................######......###..###..####......................................########..........##......##
####...######.......................#####..................###.......................................##.......................##
###....######.......................####...................###................................................................##
##.....######.......................####......................................................................................##
#......#####.............##.........####...................................................##..................###............##
#......#####............####.........##..................................................#####.............########...........##
#.....#####.............#####........................#..................................######............#########...........##
#....#####..............########....................###..............###...............#######...........##########............#
##..#####......###.......#######......##............###..............####......##.......######...........#####..##.............#
########........#.........####......####..............................####.....###.......####...........#####..................#
####......................###......#####.........................##...####......####.................########..................#
###......................####......####........................#####...##........#####..............##########.................#
###.....................######....####...................###########..............#####............#####.#####.................#
###.....................#######..####...................###########...............#####............###....####.................#
###....####..............###########....................##########......########..#####............##.....####................##
##....######..............#########......................#########.....###############.............##....####.................##
##...#########..............######.................###...#########.....##############..............##...####..................##
###.#############......##....####..................####..##########....#####..#######...................####..................##
##################..#####....####..................####...##########..#####....#####.....................##..........###......##
#########################....#####..................##.....################.....####.................................####.....##
########################......####.....###.................################......##.....##..........................#####.....##
########################......####....#####..........S.....################............####.........................#####.....##
########################......####....######..............###############............#####..........................#####....###
########################.......##.....######..........##################............####..............##............####.....###
#######################................#####.........##################.............####...........######..........####......###
######################..................###..........##########..#######.............###..........#######.........####.......###
#####################...............................#########......######............#####........#######........#####........##
####################................................#######.........######..........########.......######........#####........##
#################....................................#####............#######.......###########.....####.........#####........##
################......................................####.............#######.......##########......###.........#####.......###
################........................................###.....###....######..........#######.......###........#####.......####
#####...########.....###................................###.....###....#####.............####........##........###.........#####
##.......#######....####..............................######....###...#####...................................####.........#####
#.........#######..####..............................#######....#########....................................#######.......#####
#.........############..............................#######.....########....................................#########.......####
#..........##########.....##........................#####.......#######...........#.........................###########......###
#...........#####........####.......................####........#####........#######.......................#############......##
#............####........####.....##................###..........##.........#########......................########...##......##
#............####.........###....###...............####.....................##########.....................####...............##
##...........####.................#..............######......................##########....................####...............##
##............##..............................#########..................#.....########....................#####..............##
###...........................................#########..................##........####.........##.........#####.............###
######........................................##..#####..................#..........###........#######.....######............###
#######..............................................#..............................####......#########.....#####.....##......##
#######..........######..................................##.....###..................####....##########.....####.....####.....##
#######.........##########..............................#####..#####..................###....#####..###.....####....######....##
#######.........###########............................#############...................##.....#......###...####....########..###
#######.........############...........................#############...................##............#########....##############
#######.........#############..................##......#############...................###...........#########.....#############
########....#################.................####.....#######.#####...................###...........########.......#####..#####
########....############..##....##...........######.....#####...#####..................###............######.........##......###
########.....#######...........########..###########.....###....#####.................#####...................................##
########......######...........#####################............#####...............#######....................................#
########.......#####...........###.....#############............#####............#########.....................................#
########........#####..........##.......##......#####............####...........#########......................................#
########.........####.........###...............######............##............####...........................................#
#######..........####........###................##########...#........###........##............................................#
########.........###.......####.................##########..###.......####.......##.........................##.....###........##
#########........###......####..................#########...###......#######....###........................####...#####.......##
##########......####......####...................#######....####....###############.................##.....####...#####......###
##########......####......####.......................##......#####################..................##......####..#####.....####
#########........##........##.................................#########...#######............................##########....#####
########.......................................................#######.....#####.....###.....................#########....######
#######...............##..................##...................#####.......#####.....####.....................########....######
#######.............#####.................###..................####.........####.....####......................#######....######
######.............#######........###.....###.................####..........####......##.......................######......#####
#####....##.......##########.....####......#............##########.........####................................####..........###
###.....####..###############....####..................###########.........####................................####...........##
##.....######################....####..................###########..........####..............####.....###....#####...........##
##.....#######################...####...##..............#########............####.............####.....####..#########........##
##....############...###..####....#########..............##...................####............####......########..#####......###
##...########..............##......########....................................###............####.......######......###.....###
##...#######.......................######.......................##........#....####......#########........####........#......###
############......................#####........................####......###...###################........###......#..........##
#############...................######.....................########.............##################.......###......###.........##
##############....##...........######.....................########...........................####.......####......####........##
#####################..........######......................#######..................................########.......##.........##
#####################...........#####.........................###.............##...................##########.................##
######################...........#####.............##.......................#####.................############................##
#####....###..############..........###....###.....###.....................######...........###########....####..........#....##
####...........############..........#....#####....####.....................####...........###########......###........####....#
####...........##############............######....#####...................................###########.......#........#####....#
#####..........################..........#..##........####..##.............................###########.................###....##
######.........#################.......................########.............................##########.............E..........##
######.........##################......................##########......................###........###.........................##
#####...........#################..........##.........###########......................###.....................................#
###..............#################........####.........#########....................................................#######....#
##................######..#########.......####.....................................................................#########..##
##........##..##...####....########.......####...................###..........................##..................##############
##.......########...##.....#######........#####................#####.........................####................#######..######
##.......########..........####..........#######...........#########.........................####................######....#####
##........#######..##.......##.........###########.........########..................##.......###.......###.......####.....#####
###...........##..####.................############..........####...................###........###......###................#####
####..............#####................##..########.................................###.........#......####...............######
#####.............#####.........................####................................##................####................######
######............#####..........................####..................................................##..................#####
######.............####..........................#####......................##..................##....................##...#####
######..............##..........................######....##................###.................#....................####...####
#####...................................###....######....####.........###....#.......................................#####...###
###....................................####...#######....####........#####................##........................#######...##
##..................................#######..########...####.........#####...............####.......................########..##
##.................................#######...#######....####........######.#............####.......#......##........########...#
##...............##.................#####.....######....###........#######.#...........#####......###.....##............####...#
###..###........####...........................####.....##........####..##.#....##.....####...............##..............#....#
#########.......###............................####..............####....###....#......####...............###......##..........#
########.......###.............................###...........#######.....####..##.......####..............###.....####.........#
#######........##..............................###..........########......########......####...............#......####.........#
######........##................................###.........#######........##########..######.....................####........##
#####.........##...................#.............##..........######.........###################....................###........##
####..........##..................###....##...................#####..##.....####################...................####.......##
###...........###..........##.....####..####...................###..####.....##...###..#########...........#####....###.......##
###...........####........####.....#########...................###..####..................######...........######....##.......##
###...........#####.......####.....########.........................####...................#####...........#####.....###......##
###.....##.....####........###.....#######..........................###.....................###.............###......###......##
###....####.....##..........###....######............................................................................###......##
##.....#####................####..####.....................................###.......................................##......###
##.....#####.................########.....................................#####..............................................###
##......####..................######............##........................######..............###............................###
##.......##........###........#####.............####......................######...........######.................###.........##
##.................####.......####..............#####.....................######..........######.................#####.........#
#..................#####.....###......##........######.....................####...........#####..................#####.........#
#....###..........#######...####.....####......#######..........###........####...........######.##.............#####..........#
##..#####.....##################....########..#########........#####......#####....####...##########........#########.........##
###########################################################...#######....###############################...###########...#######
################################################################################################################################
