################################################################################################################################
###..........................................................................................................###################
###.#######..............................########.........#################################......########.....############..####
###.######...............................########..........###############..#########..###........###.........###########...####
###.#####......................###........########.........#############.....#######.........................###########....####
###.#####..................#..######........######...###...############......#######........................###########.....####
###..###...........####...##########.........######..###...####...###.......#######.......###..............###########......####
##................######...#########...........####........####............#######.......######............#######...........###
##................#######...#######.............###.......######..........######.........#######.........#.######.............##
##.................######......####.............###.......######..........#####...........#######.....####..#####.............##
##..................#####.......##......#......####......######.............##..................###..####....####.............##
##..................#####..............###.....#####....#####....................................#######......##..............##
#..................######....##.........###.....############.....................................#######......##..............##
#................########...#####........###......#########......................................#######.....###...##.........##
##..............########....######........##.......#######....................####.............###..###......###..###.........##
##..............####........########...............######....................#####............##............###....##.........##
###..............##..........#########.............####......................#####.......#######...........####...............##
###.##........................###..####............###........................###.......########...........###................##
###.###........................##...####................................................########...........##.................##
###.###..............................###.................................................########..........##...###......##...##
###.####.............##.......................................................................####.........#....#####...####...#
###.######..........###..............................##.......................................####........##....######..#####.##
###.#######.......####...##.........................####.................#....................#####.....#####....#####...#######
###.#######......####...####........................####................###....................######..######....#####...#######
###.#######.....#####..######.......................####.........................................###########.....###############
###.########..################.......................###..........##...................#..........##########.....###############
###.###########################.......................#............##.................##..........##########.....###############
###.############################....................................##...........................###########.....###############
###.############..#############................###..................###..........................###########.....###############
###.###########....##########.............##....#...................#####.......................#######.........###########...##
###.#..######......####.####.............####......................########.....................######..........##########.....#
###.....##.........###...####.........########.......###.........##########........#.............####............#######.......#
###........S.......###...#####.......###########....#####.......#######...........###............####.............#####.......##
###................###...#####......#############...####........#####..............#.............#####....##.......###........##
###................##.....###......##############...##...........###............................############........#.........##
###....##..........................##############................##............................#############..................##
###...####...##........##...........#############...............###.............................###########....###............##
###...####..####......####............############..............####.............................#####..##....#####......#....##
###....##...####......######...........###########..............#####.........................................#####.....####.###
###.........###........#########.......###########...............######........................................###.......#######
##.........###...........########.....###########...................####..................#####..........###..............######
##.........###.............#######...###########.....................####.................#####......########.............######
##.........###..............#####....######...........................##.................####........#########...........#######
###........####.............###......#####...................##..........................###.........##########........#########
###........#####...........###......#####.......#####........##..........................###..............#####.......##########
###.......######..........#####..#######.......#######.......##..........................###.........................###....####
##........######..........#############........#######......####........#...............###...........................#......###
##........##.............#############..........#####......#####.......###............#####..................................###
##.......##..............##############..........###......#####.........#####.......########.................................###
###......##.....###.......##...############.......##......####...........#####......########.............###......####......####
###............#####...............########.......###.....###............#####.......#######............#####...#######....#####
###...........######................#######.......####....##.............####..........#####............##########...###########
###..........######.................######........####...###..............###...........####.............########.....##########
##...........#####.................#####..........####...###......................#.....###...............#######.....##########
#...........######................####...........####............................##.......................########.....#########
#..........#######...............####......##########.............................#.......................########........######
##.........########.............####....#############.....................................................#####..............###
##..........########............####...###############....................................................####................##
##.............######..........#######################....................................................####................##
##...............######........#######################......####....................................###..######.......##......##
###.......#.......######......#################....##.......######.................................##############....####.....##
###.#....###.......###########################..............#######.....................###........###############...#####...###
###.##...###........###############...###..###................######...................####........###############....##########
###.##..#####........#############..........#...................#####.................#####........#######......##....##########
###.##..######........############...............................####.................#####........####...............##########
###.##..#######........#####...###...............................####..................####........###.................#......##
###.###.########................#...............................#####...................###.........##.........................#
###.###..#########..............................................#####..........##........#..........###........................#
###.###....########.............................................######........####...................##........................#
###.###.......#####............................................########......#####...................##........................#
###.####.......####.......................................#############......####.............................................##
###.######.....####......................................#############.......####............................................###
###.######.....###...............................###.....############........####...........................................####
###.#####.....####...............................###.....###########..........##...........................................#####
###.####...########..............#...............###.....#######.....................................##....................#####
###...#############.............###...............#.......#####.......###...........................#####..................#####
###...#########..#.............####...................................###......................##..#######.................#####
###...########................####....................................####....................############....######.......#####
##....#######.................####...##......##...................#################..........############.....#######.......####
##.....######..................##...####....####.................###################.........###########......#######.......####
##.....######.............##........####....####.................###################..........##########.....########.......####
##....########...........####........##......###................###################.............#####...########..##.......#####
###..#########..........######...............###..............##################........................#######...........######
#######....###..........#########...........####..............#################........#................######...........#######
######......###.........##########....#########..................###############......###..................##.........##########
######......########.....#########..###########....##.............##############......###..............####..........###...#####
######......#########......######..###########....####.............############......####...............##..........###.......##
#######.....##########......####...##########....#####.............##########........#####.........................###.........#
########....##########.......##....#########.....####...............########........########.......................###.........#
#######.....##########............###............##.................######..........#########......................###.........#
####.........########............###............##...........###....#####...........##########.....................###.........#
###..........#####......###....#####...........###..........#####....####..............########...............#....####........#
###..........####......####..########........#####..........######....####...............########............###....##.........#
##...........####......###..##########...#########...........#####....####.................########.........####...............#
##...........####......###############..###########............##.....###...................########......######...............#
#............####.....###############....##...#####...................##.....................#######.....######...........##..##
#............####.....##############...........####...................##..........###...........####....#####............###..##
#.............##.....###############............##...................###.........####............###....####.............###..##
#.....##.............################..............................#####.........####............###.....##..............##..###
#....###.............#####......#########.........................#######.......####.......##.....#..........................###
##..####..............###.......##########........................########.....#####....#####................................###
#######........................###########........................#######......######..######.................................##
#######........................#####.####..........##.............####........##############............#.....................##
########.......................####...##..........####.............##.........##############...........###....................##
########.................##.....###..............####........................####..########.....##......####..................##
###...#.................####....###...........######..........###............###.....#####.....####......#######..............##
###.....................####....###..........#######.........#####....................###......#####......#######.............##
####....................#####..####..........#######........#######...........................E######......#######............##
#####..................###########...........#######......####...##.............................#####........######...........##
######...............############............######......####.............................####..####..........#####...........##
#######.............############..............#####.....####..............................#####..##...........#####...........##
########...........############.....##........#####....####..............................######..............######...........##
#########.......###############....###........#####....###................##.............#####............########............##
###....###.....#######...######.....#..........#####..####...............####............#####...........#######...............#
##......###....######.....######................##########...............####.............####...........#####.................#
##.......###...######.....#######.................########..............####..............####..........###....................#
##.......####...####.....#########.................#######..............###...............#####.........##....................##
##........###............#########.................######....#####......###..............#######............................####
###........#.............########.................#######...########.....#..........##..########...............#...........#####
###.......................######.......######....#######....#########..............#############..............###..........#####
###........................#####.......#######..#######.....##########.............############...............###..........#####
###........................####..........###########.........###...####...........############......#.........####........######
##........................#####...........#######...................###......################......###........#####.......######
#.........................#####..........#######......................##....#################.......##.........###........##.###
#.........................#####.........#########...##.................##..###################.....###........................##
##...................##..#######......#################..###..###......################################......................###
####...###########################################################....##################################...###.............#####
################################################################################################################################
