################################################################################################################################
#####################..######...##############################################...###############################################
##############..###..............###############...##################...#####.....#######..##################.....##############
############.....................##############.....############.###.....####......#####...........##########......#############
########.........................##############.....############..........###........###............#########......#############
###.............................##############......#############..........#..........#######.......##########.....####..#######
##.............................##########............#####..######..##................##########.....##########....###....######
##............................#.......................###....##########...............###########.....###..#####....##.......###
##............................#................####...###......#########...............###########..........####....###.......##
##.................##........................############.......###########...............##########.......#####....####......##
##.........###....####......................##############......############..#............##########......#####....#####....###
##........#####...####........#.............################....################..........#####..####......######...#####...####
##........#####...#####...#####.............################.....##############........#######....###........###.....####..#####
##........####.....############.............################.....####....######.......#######.....###.................####.#####
#........####......############.............#############.........##......####.......########.........................####..####
#........###.......############.............###########...................####.......#######..........................####..####
#.......####...##.#############.............##########.....................###........##...............................###...###
##......#######################...............########......................##............................######.......###...###
###.....#######################...............#########..................................................########.......###..###
####.....###################..................###########...................................##...........#########......###..###
####.....######......######.................##############........##......................#####..####...##########...........###
###......#####..............................###############......####....................##################...#####...........##
###.......#.................................#################....#####........###........#################.....#####..........##
##...........................##.............##..##..##########..#######.......####......##################.....#####..........##
##..........................###.............#........###################......###########################......####...........##
##...................##.....###......................######...###########.....###########################.....####............##
###....................#....#####..##...............######.....##########.....###########################.....####............##
###...###...........#####...##########..............######.....###########....###########################.....####............##
###..#########......#####...###########............#######.....###########.....###########################.....####...........##
###..##########....#####....############....##.....#######....############......############################....###...........##
##....##################....############...####.....######...######....####......#################...##..........##...........##
##......################....###########....#####.....####...######......####.....#################....######.................###
##.............##########...##########....######.....####...######......#####.....################....######................####
##..............#########....#####........######....#####....#####......######....###############.....#####...###..........#####
###...............######.......###.......######....#######...#####.....#########...#############......#####..#####........######
####...............#####.................###.......#######....####.....#########....########..##.......####...#####..###########
########............####............##..####........#.####....####.....######........######...###.......##......################
##########...........###...........#############..............###.......####.........#####....####...............###############
##########............#.....##.....##############............###........####........######...###########..........#####..#######
##########..................#......##############.........#####........####........######...##############.........##........###
#########........##...............###############.........#####.......###.........######...################...................##
###..####.......####.............#######..######...........###.........#..........#####....################...................##
##....####.......####.....##...########.....#####.........##.....................#####....################....###............###
##....######.....####....###############..................#......................###......########..####.....######.........####
##....#######....####....##################...............##.....................##.......#####......##......########......#####
##....#######....####....###################..............###...............##..###........###.......##......#########....######
##....########..#####.....##################...............###.............########.........##.......###......#######....#######
##....###...#########.........###############..............###......###...##########.................###.......######.....######
##....##....########..........################.....................##################...............#####......#####.........###
##....##....#######...........#################....................###################..............#####......#####..........##
##..........######.........####################.....................##################.............######......######.........##
##.........###............####################.......................################.........##...######.....#######........###
##........###...........##############...###..................##......##############.........####.######.....########........###
##......#####..........##############.......................######.....##########..........#############....########.........###
##.....#######.........##############.S....................########.....########..........#############....########....##...####
##.....##########......##############......................########.........###..........##############...#########....##...####
##....##############..###############.......###......##.....##..............##........#################...#########....##...####
###...#########################....#........#####.....##...................###........#################...##########..##....####
###...#####################..................#####.....###.........###########........#######..#########...############.....####
###....################......................######....####.......#############..........###......######...############.....####
##........####..######.......................######.....########################.........##.......######...###########.......###
##.........##...............................########.......#####################.........##......#######...#########.........###
##.........................................####..#######........##....##########.........###....########....##...............###
##.........................................###....########.............#########.........###....########..................######
##.........................................##......########......#####....######.........###...##########.........##.....#######
###.....##.................###......................########...########....#####.........##...#######################...########
####...###..................#..........................#################......##..............#######################...########
#########............................##.................###########..####......#.............#######################....########
#########......###..................####................##########....####.....#.............##############....#####....########
#########....######.................#####...............##########......#.....#######........#############......####.....#######
##########..#######..................#####......##......###########...........#######........############.......####......######
##################....................####......###....#############...........######........############........####......#####
####.#############.....................##.......######################..........####..........############........####......####
###...############..............................#######################..........##.............##########.........###.......###
####...##...##########..........................#######################.........................###...#####.........#.......####
#####........##########.........................########################........................###....#####....#...........####
#####............#######.........................#########################......................##.....#####...###.........#####
#####.............######.........##................########################....................##......####....###.........#####
#####..............#####........####...............########################...........................####.....###..........####
####..........##...#####.....########.........##...#######################...............#######......####.....####..........###
###....###...###########.....#########......#############################...............#######........##......#####.........###
###...####....###########....###########...##############################..............#######.................######.......####
#########.....############...############..###############################.............######.....#............#######......####
#########.....############...############...##..######..###################.............#####....###..........#########.....####
#########.....############....###########........####.....##################.............####....###..........##########.....###
#########....############......###########..................#########....##...............###..................########.......##
########.....############.......###########...................#####...........................................................##
#######....###...#########......###########....................###..............#######.......................................##
######....###.....#########....############....................####.....###....########.......................................##
#####......#......#######################.......................######################........##................#.............##
####.............#######################........................###################..........####..............###.....#......##
###............##########....###########..........#.............###################..........####..............###....###.....##
###...........##########......##########.........###............#####################.......######.............##.....####...###
###...........#########.......#########.....###...###...........##################################............###......#########
###............######........#######.........#....####..........#################################.............###.......########
####......##...#####.........####.................#####..........##....######################...........###..####........#######
#####....####.#####...........###................##########..............########..#########...........#########..............##
######..####...................##................###########..............######....#######...........#########...............##
############...................####..............####....###...............#####....#######....##....#########................##
############...................#####............####......###........###..#######...######....###############.................##
############....................###...........######.......###......#############...######...#################................##
############...................#.............######....##.####.....#############....######...##################..............###
#######...##...........................##...######....#######.....#####...######....#####.....##################....#####....###
######................................###########.....#####.......####.....#####..E.#####........##..###########...#######..####
######...............................##########........##.........###.....#######....###.............###########...#############
######...............................#########....................###....########....###.............##########...##############
########.............................#########..........................##########...###..............########....##############
#########.............................##..###..........###.............###########..####................######....##############
###########.................#.........................######...........##########...####.................####.....##############
############................#.........................#######.........##########.....##............##.....##......######...#####
############................##.......................#########........######......................####...###.......####.....####
###########.................####...##.........##....##########........#####......................###########........###.....####
##########..................###########...#############..####.........###........................##########..........#......####
###..#####..................###########################...##.........###..........................#######....................###
###...####..................##########################..............####..........................######.....................###
###....##..........###....###################....####............#######...........................#####.....................###
####..............#####...##################......##............########............................###......................###
######...........######...###########...###.....................########....................................................####
#######..........######....#########.................###.......########.....................................................####
#######....##....#####......##..####...............#####......#######......................................................#####
###.......####....####...........####..........########......#######.......##..............###......................##....######
##........####.....###..........#####..........#######......########......####.............####....................#############
##...##..#####.....####.........#####.......................#########....######............####...................##############
###############...#####.........#####.......................##########..#########..........####...................##############
#######################.........#####.......................######################........#####..................###############
#######################........######......###.....###.....############################..######....##....###....################
########################....##########...#######################################################..###########..#################
################################################################################################################################
