################################################################################################################################
#######.................................................................................................................########
#######..........###.....####.....#####..########.#######...###...........#.............................####.##########.###.####
##..###..........###.......#.....#####.....#####..#####...................###..........................##....######...........##
##...#####.......#................#####...#####.....####.....#............###..................###..........#####.............##
#....######.....##...............###############.....#.......#..........######.........##.....#####..........##...............##
##....####........................#########.#.#........###.#####......########........###.....######..........................##
##.................................#....#.....#..........########......######.....#...####....#######.........................##
###......................................................########....#########....#.....#.......#####.#.......................##
###...........................................#.#..........######......#######....#.............#.###.#......................###
###...........................................##...........####......##########....................##.##.###.................###
###...........................................##......................#######.....#................##.#######...............####
##............................................##.....................######.......#.#.......#.......#.########..............####
##............................................###....................######.......#####.....#.......#.########....#........#####
##.............##..............................##....................####.........#######.###.......#.###############.....######
####..........##.....................................................####.####.....#.########.......#.#####.#..#####.....#######
######................................................................#...####........#######.........###.....###..........#####
#######.........................#.#........................................#.#.#......######..........###......##..........#####
#######.........................###............................................###...########..........##.....##............####
#####...........................#####................................................########.........###......##.........######
####.............................####................................................####.###...##.....#......###..........#####
##..............#..........##...#####.....................####........................#....##....#.....#.#.....####...........##
#......#.#.####.#..........###...###...................#...##..........................................###....#####...........##
#......##########..........####.####...##.............########.........................................####....#####...........#
#.....####...#####........#####........##.........#....#######......................................#.#######.#######.#.......##
##.....###....####.........####.......###.........#....########....................................##.######...########.#....###
##.............#####......###..............#.....###....#######.....................................#.#######.####.####.#...####
###.............##......................######....###...#######.....................................#.####..........###.########
###...............##....................#####....####...#######........................................#..............#.#....###
####...........######.##........#.#.....######....####...#####...........#..............................................#...####
####..............###.#.........###.....######....####....######.........##...........................................#.##...###
###..............####.#.........###......######....##......#######.....####..........................................##.##...###
#####.###.........###...........#.......#######..............#####.....####.........................................###.###...##
#########.......####....................#######..............###.#....#####.................................##.....####.###...##
#########...#######....................#########.............#........####..................................##.....####.###...##
####.####....#####....................#########............###....##.####......#.............................#...######.###....#
###..###.....####.......................#...###...........###.....##.###..............................###..........####.####..##
####..........##...................#.........#............###....###.##...............................###..........####.####...#
######........##............###..####.......###............#....####..................................###...........###.##...###
#####.....................#####.####.......###..................##.....................................#.............#........##
######...................######.####........###............................#....###...............#..........................###
#####....................######.##.........##.......###...................##.....#...............#...........................###
######...................######.#..................######........................................#...........................###
######.....#............#######.............S......#######..............................##.#..............##.................###
#######...###............######....###.............#######..............................###..............###.....#...........###
######...####...........######.....###.............######................................###.............####...##............##
######...####...........#####.......###............####.......#...............#..........####.............#....###............##
######..####...........######....................####........##...........#.#####........####...............######......#.....##
#####..####............######.................####...........###..........########.#.....####................#####....#.###...##
##########.............#####...................#.............##..........###########.....####..............######.....#.########
##########..............####....#.#...........................#............###..#####....####..............####.......#.########
########........##.......##.....###...............................................###.....###............####.........#.########
########......######.....###....###...................................#..........##.#.#.#####.............##............########
######........#######....###.....##..................................###..............#######.......#...####.............#######
######...#.##########.#######.........................................##........##.....#####......###.#####...............######
###....##############.########...#..............................................##...............####.######..............#.####
###.....####.#.######.#########.##..............................................###.............#####.#####.......#..........###
#................##.........###.###..............................................#.............######..#####....###..........###
#...............####.........##.###..................................#..........#...............####....##......###...........##
#...............####.........##.#.........##......................##.###..........................#.....###.....##..........####
#...............#####.........#............#......................##.###................................##.......#........######
##....####.....#######............................................##.##.......................##........###....#.#...##.###.#.##
#.....######...########......##......................................#........................###.......###....#####..#.#.....##
##....###################....##............##........................#........................##........####...####..##........#
##....###################..####....#.#.#.####...................#.............................##.........##...................##
##.....##################..####....###########.................#...#.#........................##...............................#
##.....#######################.....############................#.#.#.#........................##......................#.......##
###.....########.##############.....########...................#.###.#####.........###.........................#......#.......##
###.......#####.....##########......######........................##.#######.......###.......................#####...##.#......#
###.........###.......########......######............................########......##....................#########..##.#.....##
##..........###.........#####.......####.................................######....#.....................#########..###.#......#
###..........##...........#.........####...................................###.........................################.......##
####.###....###...........###.......####...................................####........................################.......##
#########.#.####...........##...#..####....................................###........................#################......###
###########..###............#...#...###...................................#####.....................#.#######.########.......###
##########....###................##.#....................................########.#.................#.#####...#######......#####
#########..........................#.......................................#.#######..............###.######...#####......######
#########........................###......................##...................#####.............####.#####...#####.......######
########...........................#......................####........##..........#..............####.###.#...####......########
#########...................................#............#####........###........................####.#.......###.......########
########...................................###............######.....###...#......................###...................###.####
#######..............................#....####............######.....###...##.......................#...................#...####
###.................................##.....###............#######.##.##...###...........................................###...##
##.................####.............##......#...........#..######..#.##....##......#.....................................##...##
##.........###....#######.........####......#.#.........#######...##.#.....##.....###..............................#.....#.....#
###.........#.....########........####.....####.......##########...................#...............##.......###...####...#.....#
###.........#....#########......#######....#####......#########..................................####.#.......#.#####.........##
###...............#########......######....####......##########..................................####.#.#.......######........##
##......#...........######...##.########....###......#########..................................#####.#.#.......####........####
##.....##............####....##...#######...#.......##########...........#.......................####..###......####.........###
##..................###......##..########...#.......##########.#........##......................#####...##......###..........###
##..................###......##...########...........#.#.#######........##..........#...##......####...###......####..........##
##.................##.......###..########..................######......####.......###...##.....######...##.......###.........###
##..........................#############.................#######.....#####........########....#####..#####.....######.......###
##........................##############....................######.#.######........#...####...#########################....#####
##.......................#################...................#######.###.###.........######...#########################.#..#####
##......###.............##################.......#####........######.#.........#####.######...#########################.#.######
##......####..........####################.....######.........######........#.############....###########....##########.########
#.........###..........##################.......###.#.........######.........#############.....########......##########.########
##.........####.#.........#.##############......#.....#.......#####............###...#.#........######........#########.########
##..........#####...........############..............###.#.######...............................####........######.###.########
##............###...........##########.....####......############.................................##...........###.......###...#
###........................###########.....####.#...############...............................................#...........##.##
#............................########......########..###..#######.............................................................##
#...............................#######......#.###...#......#.#.............###.....#.....#.................................####
#................................########......#.#........###...#...........###....##########................................###
#..........###.....##............######.#........#.#......##.....##........###.....##########...............................####
###...##....##....####............#####..........##.......##....####.......####.....#########............#..................####
#########....#.....#.........#...#####...........###.............###.......###......#########...........####..............#.####
#########..................#####.######.........####...........#####.......###.......#######...........####.............########
#######................###.###########...........###...........#####........#.........######............###...............######
##......................###############........................##....................#####.................................#####
###....................###############................................................#####.....#...................##......####
##...........###........##.############.................................####.........#####.....##...................##......####
##...........##........###...#########.................................#######.......#####....###..................###.......###
##...........###.......#.....##########....#..............................####........###............................#.....#####
##..........###......###.......######.#.#####.................##...........###..........#...........................###....#####
##..................####.....###.##...#.#####.................####.#......####.......................................##.########
###.................#####...............####................########......####......................................###.########
##..................####................######..............########......###.............#.....#...................###...#...##
##...................####...............E.####.#..........##########.#..#####.............###.######.......###.....###........##
#...................####..................######.........###########.######..............####.####.........####....###.........#
##................######....................####.........###########.######................##.#######.......###...###.........##
##...............#####.........................#.#......##########...#####............####..#.#.######.....####...####........##
####.............######...............#..........#.#.....#########....####...........######.#...#######.....###..####.......####
######.#...############.............###..........#.#.#.###########....######.....#.###########...########.####...######.########
#########################.##################.....#############################################.#################################
################################################################################################################################
