################################################################################################################################
######..........##.#.#.#........#.#.######.#.#.#.#####........#.#.#......#.......###.......############.......##...........#####
###.........................................................................................#####.#.#........................###
#............................................................................................####.............................##
##............................................................................................................................##
#..............................................................................................................................#
#.............................................................................................................................##
#..............................................................................................................................#
#.............................................................................................................................##
#.............................................................................................................................##
#.............................................................................................................................##
#.............................................................................................................................##
#...................................#..........................................................................................#
#...................................##.........................................................................................#
#..................................###.........................................................................................#
###.................................#..........................................................................................#
###............................................................................................................................#
####...................................................................#.#....................................................##
####..................................................................#####...................................................##
####...........##......................................................###...................................................###
####...........##.............................................................................................................##
##.............##..............................................................................................##.............##
##.............................#...............................................................................##..............#
##............................##...............................................................................................#
##............................#..........................##....................................................................#
#...............................................S........###...................................................................#
##......................................................####....................................................##.............#
#......................................................####...........###.......................................##.............#
##.....................................................###.............####.....................................###............#
#......................................................#.................##......................................#.............#
##.............................................................................................................................#
##.............................................................................................................................#
###...........................................................................................................................##
###...........................................................................................................................##
###...........................................................................................................................##
##............................................................................................................................##
##..............................#.............................................................................................##
##............................#####...........................................................................................##
#............................#######..........................................................#..............................###
##...........................#######..........................................................###.............................##
#............................#######..........................................................###.............................##
##...........................######............................................................##..............................#
#............................####......................................##......................................................#
##............................##........................................#......................................................#
#.......................................................................#......................................................#
###............................................................................................................................#
###............................................................................................................................#
###............................................................................................................................#
##.............................................................................................................................#
##...................................................................................###.......................................#
#....................................................................................###...........................###.........#
##.................................................................................................................###........##
#..................................................................................................................####.......##
##..................................................................................................................###......###
##...................................................................................................................#.......###
####........................................................................................................................####
####........................................................................................................................####
##...........................................................................................................................###
##...........................................................................................................................###
#............................................................................................................................###
##...........................................................................................................................###
#............................................................................................................................###
##.........................................................................#.................................................###
##.........................................................................##.................................................##
###...........................................................................................................................##
###...........................................................................................................................##
##............................................................................................................................##
##...........##...............................................................................................................##
#............##...............................................................................................................##
#..............................................................................................................................#
##............................................................................................................................##
##.............................................................................................................................#
###........................................##.................................................................................##
##........................................###..................................................................................#
##........................................##..................................................................................##
#.........................................##...................................................................................#
#.............................................................................................................................##
#..............................................................................................................................#
#.............................................................................................................................##
#..............................................................................................................................#
#.............................................................................................................................##
##.............................................................................................................................#
#...............................................................#..............................................................#
##............................................................###..............................................................#
#..............................................................#...............................................................#
##.............................................................................................................................#
#..............................................................................................................................#
#..............................................................................................................................#
#..............................................................................................................................#
#..............................................................................................................................#
#....................................................#.........................................................................#
##...................................................#.........................................................................#
##..................................................###........................................................................#
###.................................................####.......................................................................#
##..................................................####.......................................................................#
###..................................................###.......................................................................#
#....................................................##........................................................................#
#.............................................................................................................................##
#.............................................................................................................................##
#.............................................................................................................................##
#.............................................................................................................................##
#..............................................................................................................................#
#.............................................................................................................................##
#..............................................................................................................................#
#..............................................................................................................................#
#..............................................................................................................................#
##.............................................................................................................................#
##.............................................................................................................................#
###............................................................................................................................#
###............................................................................................................................#
###............................................................................................................................#
##.............................................................................................................................#
##...................................................................................................................####......#
##...............................#..................................................................................#####......#
#................................#................................................................................#####........#
##.............................#.#................................................................................###.........##
##............................####................................................................................#............#
##............................####.............................................................................................#
###.....................................................................E......................................................#
##.............................................................................................................................#
##.............................................................................................................................#
#..............................................................................................................................#
#........#....................................................................................................................##
#.......##...........................#.......................................................................................###
#......####.........................####....................................................................................####
##....####............#.............####.#.#####...........................................................##..............#####
##.#.#######.#.#.#.######....##.#.################.#.#..........#...###.......###.#.#.#.................###########.#.#.########
################################################################################################################################
