################################################################################################################################
####......................#####################.#.######.#.################################......#####################.#.#######
####...###############....##############...........#####.....###.......######.#.......###..........####.############.......#####
####...##############......##....#####..............###.................#####.............................###########.......####
####....#####.########...........#####...............##.................###...............................##########.........###
####....####..#######..............#.................##................####................................#..................##
##.......##....#######...............................##................###.....................................................#
##......#####....#####...............................##................#...............##......................................#
##.......####......####..............................##......#.........................##......................................#
##......######.....#####............................###.....###.......................###......................................#
##.......####.......#####.........................#.###......###......................####.....................................#
##......######......######.......................######.......#......................######....................................#
##.......#####.......#####.........................#.##.....................####.....######...................................##
###......#####.......######...###.........................................########.#######........##...........................#
##........#####.......####...######.......................................##############...........#..........................##
##........######......#####.########.....................................##############........................................#
#..........######.....####....######......................................###########..................................#......##
#..........######......##.....######....S...............................#############................................#####.....#
#...........######.....###.....#####........................#...........###########..................................#####....##
#..........######........#.......##........#...............###.........#####....#..................................########...##
#...........##.#........###......#........#####...........#####..........#.....................#.#.#...............#############
#.........####..........###...............######..........#####................................########...........##############
#......#####...........#####...............#.#.#..........####..................................#######............#.#.#########
#......####............###.................................####.................................########...............#########
##.....##..............#...####............................###...................................#######................########
#....#.##...................####..........##.......###......###..................................######.................########
##...#......................####..........##.......###.......##....................................###..................########
##.###......................####..........###.....####................................................................##########
######......................######.................##.................................................................##########
######......................######...................................................................................###########
#####.......................########...............................................###...............................###########
#####.....................##########.............................................####.................................#.....####
#####....................############...........................................######..........##...........................###
####............##......#########..............................................######...........###...........................##
#####..........###......#########..............................................####.............................###............#
######..........###....##########.................#.............................###............................#####..........##
######.........####.....#########................####...............................................#.........#####...........##
######.........#####....#########........##..........##............................................####.......#####.......######
###.#..........#####....#########.........#..........######........................................####.......#####.....########
###............#####.....##.#####....................#######...............................##.....####.........###.....#########
##.............####...........###.......................###.....#..........................##.....####.........####...#####.####
##.............####............##............#................####.........................##......##...........###...#####...##
##.............###..............#...........##.................####........................##......####.#.#...........###.....##
###.............###.........................##....................#.......................##........#######...........###.....##
##......#.......##..........................##............................................###......########...........##......##
##.....###.......#...........................#..................................#........###........######............##......##
#......###....................###............#...............................#####......####.......#####..............##......##
##.....##....................####.............###...........................#####.......###........###................###......#
##.......#.....................................###...........................####........#.........##.................###.....##
###.......#........#.#.........................####..........................####..........................##.........###......#
####.....###......#####........................#####...........................##..........................###........####.....#
###......###.......###.........................#####...........................###..........................##........####.....#
###......###.........................#####.#.########.......................................................###........###.....#
##........##........................#################.........................................................#.........##.....#
###..................................#################........................................................###..............#
##..................................##################.........................................................##..............#
###...........#......................####....###########.....................................................######............#
##............#.....................###.......##########.................................................#.#.######............#
###..........##................................###########.................................###........###########.#............#
##..............................................##########.................................####........########...#............#
###........#..........###........................###########.............................######.......#########................#
###.....####.........####........................############.............................#.#.#........########................#
#####..#####........####..........................###########............................................######................#
######.####..........#...............................#######...............................................####................#
######.###.....................#......................####....................................................###.............##
######.####...................####...................####..................#..................................###...........#.##
######.####...................#####...................##............##....###...................................##.........#####
######.#####..................########..............####............##...###....................................##........######
######.######................############...........###..................................................................#######
######.######................#############..........###............................................##....................#######
######.#######..............###############........................................................##..................#########
######.######....###........####.#.#.######.................#......................................###.................#########
######.########..###........##.........####.................##...............####..................###.............#.###...#####
####...#############...................####.................##..............##########............####.......#.#######......####
####.....##########.....................###.................##.....#........##########.........#.######.......#######.......####
###............####.......................#.#.....##........##....####......#########........#########.......######..........###
#####..........###..........................###.#####.......##.....###......####.#####......#######.#.........#####...........##
######......................................#########.......##.......###...###....###.......####..............###.............##
######.#.....................................########.......##...........#.####....###.....###................###.............##
######.###....................................###.###.......##.........#######......#........................##..............###
######.#####.................................####.####...................#####......##......................####..............##
######.######.................................#..........................####...............................###...............##
######.#######...............................##............#...............#..............................#####................#
######.#######...............................#.........#.#.###.........................................#######................##
######.#######........................................########.#.#.....................................#######.................#
######....####........................................##############...................................######.................##
####........####.......................................##############.........................#........######.................##
####...........#.#.....................................########...#.........................#####.......####..................##
###............#####....................................######.............................########....####..................###
###.............###......................................####.............................#####.#......###..............###...##
###..............###.......................................#...............##.............#####........................###....##
##................##..................#....................................##...........#####.................................##
##................##..................#....................................#.............####.................................##
#..................##................##.................................................####..................................##
##................###.#.............##...............#....................................###.................................##
#.......#...#.#....######..........###..............####..................................####................................##
##.....####.###..#######..........###..............#####....................................##.................#..............##
##...##################.......#.#####...............#####...................................####...............#..............##
#####################.........#####.................####......................................####............##..............##
############.#.######.........#.#...................#####........#............................######.........##....#...........#
#######..........####................................##.........###.............................#####........##....####........#
###.#............#####..........................................###............................######..............######......#
##................###..........................................####.............................###................#######.....#
##................####..........................................####...........................####..............#########....##
#..................##...........................................####.#...........#.#...........###............########.....#.###
##.............................##................................#######........######........######..........#######......#####
#..............................####...............................#######.......#######.......######.........#######......######
##............#................####..............................#######.......########.......########.......#######.......#####
#...........###.................####..............................#######......#######.........########.....########......######
##.......#######.................###..............................#######......#######.........##########..###########...###..##
##........####....................###..............................######......#####............####...###############.####....#
##.......#####....................###..................###..........###.......######.....##..............#################.....#
##........###.....................###.........................................####......###................##############......#
##........####....................###.................####...................#####........#..................###########.......#
##.........###.....................##................#####....................##...................................#.#.........#
##.........####...................###.........##.....###.......................................................................#
##..........###....................##.........#.......................##...................#...................................#
##...........#...................####..................................#..................###..................................#
##...............................####.....................................................###..................................#
###............................#######.....................................................#..................................##
##.........................###.#######...............................................................................#........##
##.........................##########...............................................................................###.......##
#...........................#.#####.....................................E............................................#.#.....###
#.............................###...........................................................................................####
#.............................###.........#.................................##.....#............#............##.........###.####
##...........................###........#####.#.........###...............######.#####........####.........######.....##########
###.#.#.#..#.#..#...........######....############.#.########.....################################.#.#.#.##########.############
################################################################################################################################
