################################################################################################################################
###########..............................................................#######.....###############...#########################
##########..........################################...#####...#########.#######......#####.............########......####...###
##########...........######...#####.....................###.....########..######.......###...............#######.......##.....##
#####..##............#####......####............................#######....#######........................######..............##
####.................#####.....................................########.....######..........................####..............##
####.......##.......######..................................###########.....######................###........###..............##
####......####.....########................................#####..######....######................###.........###.............##
###......#####....#########..........................##########....######..#######.................##.........####...........###
##.......######..###########............##..........##########.......#############.............................###...........###
##.......#####################.........####........##########.........############..............................#............###
###.....###########.....#######....########........##########.........###########............................................###
###....###########.......######...########........###########.........#########..........................................##..###
###...############.......######...####............############........########...........###................###......###########
##....###########.......######....###............##############.......#######.............#.................#####...############
##.....####.............###.......###....####...###...#####.###.......######................................####################
##................................###...###########...####............#####.....................................################
###..............................#####..###########....##..............####.......##...........###...............###.........###
####...........###..##..........######..###########.....................##........####........#####..............###..........##
#####.........#########.........#####...####..#####...............................#####......#######.............####.........##
####.........##########..........###.....#.....###...........................###....####....########............#####.........##
##...........#########.............S...........###..........................####.....##############.............####..........##
#............#######............................#.........................######.......#######...................##...........##
#.............#####.........##...........................................######.........#####.................................##
#...............###........####.................................#.......#######..........####.................................##
#................#........######......##.......................###......#######..........####.....................####.......###
#.........................######.....####.....................####......#######..........####....................######....#####
#..........................####......####.....................###.......######............###....................######...######
##....##..............................##.................................###.......####...###....####......#......####....######
##...#######....................................................................########...##...######....##...............#####
#############..................................................................#########...##...######.....#...............#####
##############.................................................................#########.........#####......................####
###############..................###.................................###.......#########..........###.......................####
###############...........##......#........................#####.....####......#########.....................................###
#######...###............####...................##........######.....###.......#######................................##......##
######...................####..........###....#####.......#####.................#####...##.............###...........####.....##
###......................#####.........###...######......###.....................####..###..........######...........####.....##
###....................#######.........##...######.....####.......................###..####.......#######............####.....##
###...................#######...............#####.....#####.......................###...###......######...............###....###
###...................######................####.....#####........................###....##.....######.......................###
##.....................####.................####....######.........................##.....##....######......................####
#......................#.##..................###...#######.........................###....###....######.....................####
#......##..............#.#....................###########...........................##.....###.....#####....................####
#.....###.....................................#######...............................##......###.....######...................###
#......##....................................#######...............................###......###......######...................##
##..........................................########..............................#####.....##...........#....................##
###........................................########...............................#######..###................................##
#####.....................................#####....................................###########................................##
######.........................##.........####.........................................########................###.#####.....###
######.....#.....###...........###........###...........................................#########.............####.#####.....###
#######...###....###.....#.....##............................................................#####...........#####.##.........##
#############....###.....##............................................###....................####..........######.#..........##
#############....###.....###..........................................#####....................####........#######.#..........##
############.....###.....####.........##...........................#..######....................####.....#########............##
############....####.....####........####................###......###..######....................###....##########............##
############....###....#.#####......#####...............#####.....####....##...........................###########...........###
############....##.....#.#####....#######...............#####.....####.................................###########..........####
###########............#.####....########..........##...####.....####.....................######.......############.......######
#########..............#.###.....####..###........####...###....####...................##########.....####.########......#######
#######................#####.....###....##........####.........####...................###################...########.....#######
####...................#####.....##.....##........####.........####..................#####################...#########....######
###.....................#####...........##........####.........###.............###########################.....########...######
###.......##............#####...........##........####.........##..............###########################......########..######
####......###...........#####..........####....##..##...........................#####.....#########...####......########...#####
####......##............####...........####....###...............................###...........###.....###.......######.....####
####...................#####............###...####.........................##.....#....................##........######.....####
###....................######............##...####.......................#####........................###.........######....####
###...................###..###................#####....................########......................####..........######..#####
###...................##....####....###........#####..................#########.....................#####...........############
####..##.....................###########.......#####...................#######......................#####................#######
###########..................###########........####......................###.....................E...##....................####
############..................##########.....................................................................................###
############..................#######..##.......................................................#.............................##
###########....................#####...........................................................###......##.........##.........##
###########....................#####............................................................#......####.......###.....######
############....................#####..................................................................#####.......##....#######
############......##.............#####.........................###......................................####.............#######
##...#######.....###.............#####........................#####..................##..................##..............#######
#.....######......##.............#####.......................######..................###..................................######
#......####......................#####..............##.....########.....####.........###..................................######
#.......##.......................#####.............####...#########...#######.........###..........................#......######
##..............................######.............#####..#########..########.........###.........................###....#######
##..........#####..............######.............########.......###########..........###........................###.....#######
###...###########......##.......####.............#########.......##########............#........................####......######
#################.....###........................####..##........####.........................................######.......#####
################.....####.................##.....###............####.........................................########........###
#######...#####.....####.................####.....#.............####.........................................#########........##
######.....###.....#####.................####....................##....#..............########...............#########.........#
#####......###....#######.................##..........................###............############............#########.........#
####......####.....########............................................#.............#############............#######..........#
###.......####......########.............................###.........................#############............######..........##
####.....####.........######.........................#############..................######...#####.............####..........###
####......##...........######.....###.......##......##################.............#######....####.......#.....####........#####
####........................#.....####.....####.....###################............#######.....###......###...######......######
####........................##....####...######......#######################......########..............###...######.......#####
###..........................##...####..######........#######..##############.....#######...............##.....#####........####
###..........................##...###....#####.........#####....############.....#####.........................##............###
###.......#.......................###.....####....##....###......##########......####.........##..............##..............##
###.....####.....................####......###...####....##.......##..####........##.........#########.......###..............##
##.....#####.....................#####......###.#####....##..................................##########.....####..............##
##....#####.......................#####.....#########....##...................................##########...####..............###
##.....###.........................#####...##########.............##.............................#############..............####
##...............##.................################..............##......##......................###########........###....####
##..............####.................##############......................####.....................##########........#####...####
#.......##......####.................########...##.......................####....................########..........######....###
#......####......##..................######...............##.............###....................########..........######.....###
##...#####...........................###.................####...........####...............#############.........#######.....###
##..####...............................................######..........#####..............###############.......########.....###
##...##.....###..................................#############........#####...............###..##########........#...........###
#...........###.................................###############......#####.................#....########.....................###
#............#..................................###############.....#####........................#####......................####
#.....................##........................###############....#####....................................................####
#....................####.......#................######....####....####....######...........................................####
#..................#####.......###................####......###....####...########...........##............................#####
##.................####........###...###..........####......###....####...##########.........###..........................######
##.................####........##########..........####......#.....####...###########........##.......#..................#######
##.................#####.......###########..........###............#####..###########................###.................#######
##...........##....########.....###########..##....................######..########.................####................####..##
##......########....########.....###############..................#######...#######................####................####....#
##......########.......####.......#############..................########.......###...............####................####....##
###....########.........................######...................########........###..##.........####.................###.....##
############.............................####....................#######.........######.........####...........##............###
###########.......######..................##......................................###.........#####...........####...........###
##########.......########................................................###.................######...........####............##
##########......##########.....................................##.......#####.........##..##########.........#####............##
###########..################..#####......##.....##....#####..###################....#################......#######....####..###
#############################################...#######################################################..#######################
################################################################################################################################
