################################################################################################################################
#######.....................................................................................................................####
#######.###...#######...........###.....###.....###.....#######...............#############..........#####.....####....###..####
#######.###.....#####...........................####....######................#############..........####......####...####..####
#######.##......#####...........................###......#####................##############..........###.......####.#####..####
#######.###.....#####...........................###......#####..##............###############.........###.......##########...###
#######.##......#####...........................##........#####.##............#################.......###........#########....##
#######.###.....#####...........................#..........####.##..............##.#.############......##..........#######....##
###...#.##.....##...............................#............##.###........#..........############...................#####....##
###.....###....##.............................#...............#.##........###...........###.#.###............###.....#####....##
##......###........................#..........#.................###......####...............................####.......###....##
####.....##........................#.........##.................###.....######..............................######............##
####......................###....#####.......##.#......#................#####...............................######............##
#####....................#######.#######....###.#.....####.............#######..............................######............##
#####.....................########.############.#....#####.............#######.............................######.............##
######.....................#####.....##########.......#####......S....#########...........................######..............##
#######.....................#####......#######........#####...........#########..........................######..............###
#######.......................##.......................#####.........#####..#####.####.#.#..............######.....###......####
######.......................####......................####.........#####.....##############...........######......#######..####
######........................##......................#####........######.....###############...........#####.....########..####
######............................................###.####........#######.......###############.........####......########..####
######............................................########.......########........#####..#########........####.....########..####
####...............................................######........########..........#.....#########........##....##########....##
##................................................#####..........#######...................######........#####..##########.....#
##...........................####.................#.#............#######.....................####...##.#.#################.....#
#............................######.#............##..............#####..............................#######################.#..#
##...........................########...........####............#######..............................######################.##.#
#...........................#########...........####..........#.######................................##############.######.##.#
###.........................########............#####.......###.#######................................#############...####.##.#
###........................####..#.#............######....#####.########...............................############.....#......#
##.#......................######................#######..######....######...............................#############..........#
##.##......................#######.#............##############.....########............................##############..........#
##.###.....................#########............###############....#########...........................##.############.........#
##.###.......................##.#.#...............#.##########################..............................##########.........#
##.####.##............................................########################............#.##..............####...............#
##.####.##.................................##..........###########################......######..............###................#
##.####.#.................................####........##############################..#########.............##...............#.#
##.##.#............#.....................######........#########.......#############..#########.............#...............##.#
##...............####.######.#.#.........####.........########...........#######.#...###########..........................#.##.#
##.............######.############........###........####..................#####.......#########.........##...............#.##.#
##.............######.##############.....###.........##.....................##.........##########.......##........#.#.#...#.####
##.#............#####.##############......##........###..................................########.......#.......#######.......##
##.#............#####.##########.#........#.........##..................................#########.......#.......########.....###
##.#.............####.######.......................####............................##.#.########................########......##
##..............#####.#####........................####...........................##############...............#########......##
###..........#######....###.......................#####...........................############................##########.......#
##.........#########....##.........................####.................####......#############......##.....############.......#
###.........######.......#................................................###......###########........##....############.......#
##...........#####..........................................................#.....##############......###..#######.#####.......#
###............##............................................................#.....#############.......###...###.....####......#
##............###.............######...............................................##############............####....####......#
###............#............########...............................................###############.............##.....#####...##
##...........................########...............................................##############.............###...######...##
###.............................#####...............................................#############....................######.####
###...............................####...............................................############..................########.####
##................................####...............................................######...###...................#####...####
##.................................####.....#.........................................####....##...................#####......##
##................................######....#.........................................####................###.......###.......##
##.................................#########...........................................###...............####......###........##
#.................###.##..........##########..........................................####...............#####....####........##
#........#.......####.###.........##########..........................................####..............#####.....#####.......##
#.......####.....####.###.......##########...........................................#####....##........######..########......##
#........###.....####.###.......##########...........................................####.....##......#######......#.#####....##
#.......#####....####.####....#########.#............................................#####.....###...########.........####....##
#.......#####.....###.####.#.#######.................................................####......####.#########..........#####.###
#.......######.....##.############.................................................#######......###.########............########
#.......#####......##.##########...................................................######.......###.#########............#######
#........#####........####.........................................................#######......###.#########.............######
###.......#####.......###..........................................................#######......###.#########.............######
###.........####...................................................................#######.....####.#########.............######
####..........###..................................................................#######....#####.########...............#####
####..........####.......................####.....................................#######....######.########..............######
###............###.....................######.....................................#####......######.#....#.................#####
###............####...................########...................................####.........#####.#....................##.####
##..............###...................##.#####...................................###.............##..........#..............####
#.....................................#....##....................................##..........................#.........##.....##
#..........................................##....................................#..........................##........##......##
#................................................................................#...........................#........###......#
#................................................................................#....................................##.......#
##...............................................................................#.....................................##......#
###..............##...............................#..............................###...................................##......#
####............#####...........................#####............................###...........................................#
#####..........######...................#.......#######..........................##...........................##...............#
#######.###.....#####..................####...#.#########.....................................................####............##
#######.#####..######..................######.#.#########...................................###................###............##
#######.###########...................#########.##.#######....#####.......................#######..............###............##
#######.##########....................####.###.......#####.....#####....................###########..............#............##
#####.....#########..................###.............######....######.....###.........#########................................#
#####.....#########..................###...............####.....######.#.######.....###########....................#..........##
####........########................##.................####......##############...#############...................###..........#
#####.........######....#.......#.####..................#..........##############.#############...................######......##
####............###....###.....#######............###.................#.###################......................#####........##
####...................###.....######...........######...................################.........................####........##
###.............................######..........########...................############..........................####.......####
###...............................####..........########...................#####...#.#............................#.........####
###.................................####......#.##########.#.................#.......#..........................###.........####
###...................................##......#.#############........................###.......................####.........####
###...................................###.....#.##############......................#####......................#####..........##
##.....................#..............#####...#.#############.......................######.....................#####..........##
##.................##.######........#######.###.##.#.###.#.#.................############.......................#####.........##
#................####.#########################.............................#############.......................#####.........##
#..............######.#######################......................##.......###########.........................######........##
#.............#####...######################......................###.......######.#............................#####.........##
#.............######...####....############................##.....#..........#####..........#...................#####.........##
#..............#####.####.........#.######.................####.#####.........###.........####.................###............##
#..............########...............###.................###########.........####......#####............###...##.............##
##..............#####.....................................############.........####....####..............###...##.............##
#................###.....................................############.........#######.####...........#.######.###.............##
##......................................................#############..........###########..........############..............##
#...............................................###.....###########...........#############.........############..............##
##..............................#.............#.###.#.####.#########...........###.#########.........##########...............##
#........###................#.####...........##.##########...#######..........##....#########........##########...............##
##......#####.............#######...........###.########.....########..........##....#########.........######..................#
##...##.######...........########.........#####.#####........#######...........##.....#########.......#####....................#
#######....####..........#######........#######.####.........#####..............#.....##########...............................#
######.....#####..........######.......########.####.........#####.....................#########.....####......................#
#####.......#####...........####.......########.###..........####.....................#####.#####...####.........#.............#
####.......######...........###.......#########.####.........#####.....................###...####...#####......#####..........##
####......########...........##........######.....###..........###.....................####..######.#####.......#####.......####
####......########...........##.......#######.....###.................................####....#####..#####......####.......#####
###......##########..........##.........#####......###.........................#........#......#####.####........#####....######
###.....############........###........######.....####....................#.######............####.....###.......#####...#######
###.....###############.....###.........#####......###...................############.........#...E....##.......################
###...###################...####.......######......###...................#############......##.........###......################
#####.############################.#.#.####........###....########......##############.....####......####......#################
############################################.......####.############....###############...#####....#######.....#################
############################################......###################.#################.###################..###################
################################################################################################################################
