################################################################################################################################
##............................................................................................................................##
##.#####.....#####....####################........########.....................###########......................##########.##.##
##...#.......#####.....#################........#.#######.......................#########.........................######.#.##.##
#...##.........###.......##############.........###########.....................#######..........................######....#..##
###.###.......####.......#############..........#....######.....................#######...........................#####.......##
########......####........###########.................#######....................#####...........................######.......##
########......###.........###########...................#####....................#####............................####........##
#########...#####..........#..#######.............................................###............................#####......#.##
###########.######..............#######...........................................###...........................#####......##.##
####.#############.....#........#######............................................##..........................######......##.##
##....###########.....##..........######..........................................###..........................#####.......##.##
#......########.......##...........#.####..........................................##...........................##.......#.##.##
##......#######.......................###.........................................###....................................#.##.##
##........###...........................##...................................###...#....................................##.##.##
###....................................###......#............................####.......................................##.##.##
####...........................####.....##.....####..........................###........................................##.##.##
######.......................######............#####..........................###..........##...........................##.##.##
########.....................######...........######.#.........................##..........##...........................##.##.##
####.###.....................#.###............##########.............##.......###..........##...........................##.##.##
####...##..................#...###............#########.............####....................#...........................##.##.##
##.....###...............#####.................######...............####......##............##..........................##.##.##
###....###.............#########...............####................#####......#.........................................##.##.##
###.....##...........###########................####...............######....###........................................##.##.##
####...###.........#############................###..............#######....####...........................................##.##
####....#.........##############.......###..................#.#.##########..######..........................................#.##
####..............#.#.#########.......#####...............########################.....................##.....................##
####..................#####..............##..............#######.....##############..................####.....................##
###.....................###..............##..............####.........#########.......................###.....................##
###......................##..............###.............##............########..................#...####.....................##
###......................................##.....##.....................####.#...#...............#########.....................##
####.....................................#......##......................#.....######...........########.......................##
####...........................................####......................#.....####.............######........................##
######.........................................###......................##...#######............#####......##.................##
#######.......................................######....................############.............###........#.................##
#########.....................................######......................###########............##...........................##
##########......................S............#########....................###########.............#...................###......#
###########...................................########......................##########................................###.....##
###########..................................################...............#########............###.................###.......#
############.............................#.#.################.................######.............##..................###......##
#########.###............................#####################....................#....................##...........####.......#
#######...#####.........................########........#####.........................................#####.........###.......##
######......####................###......#######.........####..........................##..............####.........####......##
####........####.................###....########...........#...........................#..#####.........####.......####.....#.##
####..........#..................#####.#########............................................###..........###.......######...#.##
##................................####..##########............................................#...........##......########.##.##
###...............................################................................................................########.##.##
###................................###....#.#.######.............................................................#########.##.##
#####...............###...........#####.........####...............................................#..............########.##.##
#####..............#####...........####.........#####..............................................##.................####.##.##
#####.....###.#.#.######..........#####...........###.................................................................####.##.##
###......###############.........#######..........####..................................................................##.##.##
###......################.......########..........####..................................................................##.##.##
###........#.#.###########......##########........#####..................................................................#.##.##
###.............###########.....##########.......#####....................................................##...............##.##
##..............###########.......########.......#####.....................................................##.##...........##.##
###.............###########........#####........######.........................................#............#.###...........#.##
##............#############.....................######........................................####............##...........##.##
###...........#######.#.###.....................######.........................................###.........................##.##
##............#######...###......................######.......................................####.......................#.##.##
###.............#.#......##.......................#####........................................###......................##.##.##
###......................##........................####.................................................................##.##.##
###.....................###........................####...............................................#..................#.##.##
####....................###..........##...........#####..............................................##........##.......##.##.##
####...................###.........####..........######.............................................#####......###.......#.##.##
#####..................###........#####..........#######.............................................####.....####.......#.##.##
#####.................###.......######.............................................................######......###.........##.##
#####................####......#####........................................................#......#######.....##..........##.##
######...............###........####........................................................###.###########................##.##
######..............###........###.........................................................################................##.##
#######............####.........#.........................................................#################...................##
#######...........#####..................................................................#################....................##
####.###.........######...................................................................##########.#####....................##
##...###........#######..........................###........................................#######...###...................#.##
##.....#.......########................####....######.......................................######.....###..................#.##
##...........############.#............############...........................................###.....#####................##.##
#...........######...########........############.............................................###......#####................#.##
##..........#####.....#########.....###########.............................##..............#.........#######.................##
#.........######.......########....#############............................##.............#####.....########.#...............##
###.......#...............#####.....###########.............................###............#####.#.##########.##..............##
#####.#.###...............###.......###########............................###............###################.###.............##
###########...............####.......#########................#.....##########.............##################.####.........##.##
###########...............###.........######..........#.#....###....#########.....###.....#############..####.######.......##.##
###########...............###.........#####...........###...####.....#######......##.....#############....###.#######....#.##.##
#######...................##..........#####.......#.##############.#..######.....###.....#############....###.######.....#.##.##
######....................###.........####......####################.######......##.....#############......##.###........#.##.##
#######...................##...####.######....#########.#.################......####....#############.....###.##.........#.##.##
#######....................##..##########...#########.....##############.........###..##############.......##.##.......###.##.##
#########........................#######...########........############.............##############.........##.##.......###.....#
#########..................#.....#####......######........############................####...#####..........#.###....#####.....#
#######.###...............##.......#.#.....####..........##############........................#..............##.....###.#.....#
####......#...............##.......#........#...........#############..............................................####........#
####......#...............#.........#....................#####.#.##.#..............................................###........##
###........#####.####....#........####.....................#..............#.......................................####.......###
###.......###########..............##.....................................#........................................##........###
##.........#########.......................................................#.......................................###.......###
##.......#######.#........................................................##.......................................##.........##
#........####..............................................................##.............#.........................##.......###
##......####..............................................................###.............##........................##.......###
#.......###...........................................##..................###............###.........................#####.#####
##.....#####..........................................##.................###..............##.........................#####.#####
#......####...............###............#..............................####......................#........##........#####.#####
##.....#####.............######..........###............................####......................##.......##.##....######.#####
##.....####.............########.........###..........................#####......................####.....###.############.#####
###.....####.............##.#.##..........#............................#####.....................###.......##.############.#####
##......####.............##...###......................................####.......................#........#.........###.....###
###.....####....................................................#........#.................................#.................###
##......####..................................................###........................................#.#..................##
###.....####..................................................####.....................................######................###
##......###.................................................######.................##.................######.................###
###.....###.................................................######..................##.......##.......######.............#.#####
##......##......................###........................#######.....###.........##.......#####......................#########
##......##......................###........................#####.#.#.#######.......##.......######.....######...........########
##.....###......................####.......................#####...########...............#########.....#####.#..........#######
#......###........#.............####.........#..............##....#########...............########......#####.###..........#####
##.....###......####.............###........####...........####....####.................##########.......####.###..........#####
#.......##......#####.............#.........####............##.....###................#######....#.......####.###...........####
##......#......#####.........................#.#...#.......####.......................#####...............###.###............###
#.......#.......####......##...................#..####.....###......................#######......###.....####.##.............###
##.............#####....#.#...................##.#####......###....................######........####.....###.###............###
#..............####.....#.#...................##...###......###....................######.......######...####.##.............###
#.............#####....##.....................#....####......###..................#####.........#####....##...####.#.........###
#...........######......#...........................##.......###...................#####......########.####....######........###
#...........######......#...........................###.......###......#......E.#######.....########.#.###....######.........###
##........#######.....#.#...........................###.......####...###......###########.##########...####...#######........###
##........#######...#####..........................#####......###########.....######################.######.############.#.#####
####....###########.#####.#########.#.#.##........#######.#.###############.####################################################
################################################################################################################################
