################################################################################################################################
################################################################################################################################
################################################################################################################################
################################################################################################################################
################################################################################################################################
################################################################################################################################
################################################################################################################################
################################################################################################################################
################################################################################################################################
################################################################################################################################
################################################################################################################################
################################################################################################################################
################################################################################################################################
################################################################################################################################
################################################################################################################################
###################################################.############################################################################
###################################################.############################################################################
######################.............################.############################################################################
######################.............################.############################################################################
######################.............################.############################################################################
######################.............################.############################################################################
######################.............################.############################################################################
######################.............################.############################################################################
######################.............################.############################################################################
######################.............################.##################.#########################################################
######################.............################.##################.#########################################################
######################.............################.##################.#########################################################
######################.............################.##################.#########################################################
######################.............################.##################.#########################################################
######################.............################.##################.#########################################################
######################.............###################################.#########################################################
######################.............###################################.#########################################################
######################.............###################################.#########################################################
######################.............###################################.#########################################################
######################.............###################################.####.####################################################
######################.............###################################..........################################################
#####################################################################.............##############################################
####################..................##############################...............#############################################
####################..................##########################....................############################################
####################..................############.....................S.............###########################################
####################..................############...................................###########################################
####################..................############....................................##########################################
####################..................############....................................##########################################
####################..................############....................................##########################################
####################..................#####################...........................##########################################
####################..................#####################............................#########################################
####################..................#####################...........................##########################################
####################..................####################.......................E....##########################################
####################..................#####################...........................##########################################
####################..................#####################...........................##########################################
####################..................#####################..........................###########################################
####################..................#####################..........................###########################################
####################..................######################........................############################################
####################..................######################.......................#############################################
####################..................#######################.....................##############################################
##############################################################..................################################################
################################################################.........##.####################################################
####################################################################.###########################################################
################################################################################################################################
################################################################################################################################
################################################################################################################################
################################################################################################################################
################################################################################################################################
################################################################################################################################
################################################################################################################################
################################################################################################################################
################################################################################################################################
################################################################################################################################
################################################################################################################################
################################################################################################################################
################################################################################################################################
################################################################################################################################
################################################################################################################################
################################################################################################################################
################################################################################################################################
################################################################################################################################
################################################################################################################################
################################################################################################################################
################################################################################################################################
################################################################################################################################
################################################################################################################################
################################################################################################################################
################################################################################################################################
################################################################################################################################
################################################################################################################################
################################################################################################################################
################################################################################################################################
################################################################################################################################
################################################################################################################################
################################################################################################################################
################################################################################################################################
################################################################################################################################
################################################################################################################################
################################################################################################################################
################################################################################################################################
################################################################################################################################
################################################################################################################################
################################################################################################################################
################################################################################################################################
################################################################################################################################
################################################################################################################################
################################################################################################################################
################################################################################################################################
################################################################################################################################
################################################################################################################################
################################################################################################################################
################################################################################################################################
################################################################################################################################
################################################################################################################################
################################################################################################################################
################################################################################################################################
################################################################################################################################
################################################################################################################################
################################################################################################################################
################################################################################################################################
################################################################################################################################
################################################################################################################################
################################################################################################################################
################################################################################################################################
################################################################################################################################
################################################################################################################################
################################################################################################################################
################################################################################################################################
################################################################################################################################
################################################################################################################################
################################################################################################################################
################################################################################################################################
################################################################################################################################
