################################################################################################################################
###........................................................................................................................#####
###................######..#####................######......#.#########....####################################.......####.#####
##.................#####....##....................####......#.#######......######################..###########........####.#####
##.................#####...###....................####......#.#######.......###################......#########........####.#####
##.................####.....##...........#.........###.....##.#####.........################........#####..##............#.#.###
###................#####...###......####.###........##......#.#####.........################....#.#.#####....................###
###.#.............######.#####.....#####.###.......####.......#####.........##############......########.......................#
###.#.............#############....#####.####......####........####..........#############......######..............#.#.......##
###.#............###############.........#####....######........###............##########.......######............###.##.......#
###.#............#################.........#############........###..............#.######.......######.#.........####.##......##
###.#............################............###########........####..................#........##########.......#####.###......#
###.#.............################.............########.........###...........................############......#####.###.....##
###.#...............#############................######.........####.........#................############.......####.###.....##
###.#..#............##############.................#.#.........####.........####.............#############.......####.###.....##
###.#..#..............#############......................#.#..######......########............############........###.###....###
###.#..####..........###############...#.##..............####.######......########.............############......####.####...###
###.#..######.........##############..##.####............####.########.#######.#.#...............#########........##...##....###
###.#..######........########.#.###....#.#####...........####.##############........................######.......###.........###
###.#..######.........#####...........##.######...........###.##############..........................###........#...........###
###.#..#####.........#####.............#.#####............###.##############.....................................#...........###
###....####..........#####.................................##.###############...............................................####
###.................#####.................................###.#################......##.....................................####
#...................####..................................###.#################......####...................................####
##................####....................................###.######.#.#########....#######..........#......................####
##................####.........##.......................#####.#####......#######....#########......####....................#####
###..............#####.......###........................#####.####..........####....########.....######.....#..............#####
###.............#####........###...............#.......######.###.............##......#####.....######.....####.........##.#####
###.#........#.#####.......####...............##.......######.###...............................#####.......###........###.#####
###.#...#.#########..........#........................#######.##..................................#.........#####.....####.#####
###.#..############...................................#######.###............................................########.####.#####
###.#..#############...................................#.####.##....##........................................#######.####.#####
###.#....###########..........S............................##.###..###..........................................#####.####..####
###.#......##########......................................##.###.####..........................##.................##.##.....###
##...........########.....................#.#.................########........................#####...................##......##
##...........#########...................######...............########........................######.........................###
###.#..........#######...................######...............########.......................#######.........#................##
###.#..........#######...................######...............########........................######.........###.............###
###.#.#.........####.....................####.................#######.....................#.######...........##..............###
###.#.##.......###.......................####.................########..................##########...........................###
###.#.###.......##.......................##.................#.#######.................############..................#........###
###.#.###......###..........................................#.#######..................#############...............##........###
###...####.....###........................................###...........................#######...................###........###
###.....##.....###.......................................####.............................#####...................###........###
##......####..#####......................................###...............................####...................##.........###
##.......##########......................................##..................................##..............................###
##.......############.........................................................................#.............................####
##.........##########.#......................................................................................................###
###........###############....................................###...####.....................................................###
###........##############...................................#.####.####...............................................#......###
###.#.#.#################..........#.......................##.####.##...................##..........................#.###.....##
###.#####################.........###..................#...##.####......................####........................#.###....###
###.######################........###.................##....#.####........................###.....................###.####....##
##..###########################.#####................#####..#.####.......................#####....................###.####..####
##...##############....##############...............#########.####.......................#####...................####.####.#####
#......###########.......#.##########...........#...#######...####.......#............########.....................##.####.#####
#..........#######..........#########...........###########...####......#######......########.......................#.#....#####
#..........#######...........########......##...#########.....####.......#######.....######.................................####
#...........#######...........########.....####.#########.....###..........###.###...#......................................####
#..........#########............######......############......###..............###.#...........................#.#.##......#####
#..........##########...........#######.....##########......#.#.................#####.........................#######.##...#####
#.........############............####........####..........#.#.................######..........###.........#########.####.#####
#.........#############...........####....................###..............#.....#####.........######.#.....#########.####.#####
#........#####......###...........###.....................###......#......###.....#####........##########.#.#######...####.#####
#........####......................###...................####.....##......##.......####........############.########...###.#####
##......####.......................##.....................###....###................####........#########.....######.#####.#####
##.......##.........................#.#..................####........................###..........#####.......############...###
###......#............................#...................###.........................##..........#####........###########....##
###..................................###.................####.......................................#..........#########......##
###.##...............................###.#...............####.....................................#.#...........#########.....##
###.##..............................####.###.............####..........##.........................#..............#.######.....##
###.####........####................####.####..........######.#.......####.....................###.................########.####
###.###.........###................#####.######.#.......#####.##......###....................####...................E######.####
###.###.........#####...............####.########......#...##.###....####..................#####....................############
###.##..........#.###...............####.########...........#.###.....#..................######......................###########
###.##............####................##.#######............#.###........................#######.....................###########
###.#..............##................###.#######..............#...................#......#.#.#.......................###########
###..............####................###.#######.................................####.....................##..####...###########
###..............##.................####.#########...............................####....................#######################
###............####............#.....###.###########.............................####.....................######################
###..........######..........###..........################.#....................######....................######################
###......#.########..........####...........#################.##.#####.........#######.....................#####################
###......###########.......######...............#############.##########........##########.#................####################
###.##...####..................###...............############.############...........########...............####################
###.##...####..................###.................##########.############............#######.........#.......#.......##########
###.####.####..................####................##########.#############.............######.......###................########
###.#########..................###.................##########.#############............#######.......##..................#######
###.#########..................#####.............#.##########.#.############............#######.....###...................######
##..#########..................#########.#.......#.##########...#.#.#######...............#.###.....##....................######
##...########..................#########.##....#####.#######.........#######.................##.....###..................#######
#....################......#############.###########.#####...........#######.........................#.........###.....#########
##...###....#####............###########.##########....#...............######........................##........#################
##..........###...............##########.###########...................#####..........................##......##################
###............................#########.##########......................#####................................##################
###.............................#######..###########.....................#####................................##################
###..............................#####.........######...................########..............................########....######
##..............................................######..............#.#.########...#...........................#####.......#####
##.............................................#######.............###########......##...........#.............#.#.........#####
###.......##...................................######.............########################.....####........................#####
###.#.#.####...................................###.........#...#.##############..###########.#####.........##..............#####
###.#######..............................................####.########.....###...#################......#####.............######
###.######...............................................####.########............###############.....########............######
###.######..............................................#####.######...............##############....########.............######
###.#####...............................................#####.######...............############.......########..........########
###.#####.............................##.#.............######.#.####................###########......########...........########
###.#####.............................##.#............######....####.........#.......###....#........#########........##########
###.#####............................###.#...........######.......##.........##......#..............###.#####.........######.###
###.####............................####.#.........######.........##.......###.........#...........###...####.........####.....#
###.#####...........................####.........######............###.....###.........##.#.......####...###...........#......##
###.#####..........................#####.......########..........#####...####..........#######.#.####....##............#.......#
###.#####..........................#####.....#########.......###########.####............############....##...........##......##
###.#####........................#######....###########.#.##################...............#########.....##...........###.....##
###.######...................##########.....################.#.##############..............##########....#............###.....##
###.######...................###########..################......#############................#######...........#.......##....###
###.######..................############....#.##########.........##############................#####..........###......#.....###
###.#######..................###########.##.....########..........###########......................#.#........##.....#.......###
###.########....................########.#.......######............#########.........................##......#####.###........##
###.#########....................#######.#........#######............#.###...........................##.......#########......###
###.##########....................######.#.......##########..........................................##........########.......##
###.###########......................###.###.#.#..###########...................................................########.....###
###.#############.....................##.########..##########....................................................#######.....###
###..############....................###.#######....#########.....................................................#####....#####
##.....############..................###...####......#####.#.......................................................####....#####
#......#################...........#####....###.......####..................#.#.##.......................##.........##....######
##......##################.........####.....###.......###..........#......##########....................####.......#####..######
##......#####################.#.#########...#####.....#####......#####.#.###########............####....#####.......############
####...##################################.#########..########.#.######################.#.#.#.#.###############....##############
################################################################################################################################
