################################################################################################################################
#######.................................................................................########################################
#######...###############........###..........#########...#####........##############...##########..#########...###.#.##########
#####......#############........###.................#......###...........#####.#.##.....########......#######.....#....#########
####.......#######...####.......##........................###............###.............######...........#.....#.#......#######
###........#####......###########........................####.............###..............##...............#.#.###......#######
###........#####.......##########.......##..............####................................................######........######
##..........###..........#######.......####............######...............................................##.#.........#######
###........####............####........####..........########............................................................#######
##..........###..........................#...........########...........................................................########
###.................................................#######...............................#####..........................#######
##.........#####.#...................................#####................................#####........................#########
##.........########.................................#####................#................###........................###########
##.......##########..................................###...............####...............###........................###########
##.......####.#.##..................................###................####..............###..........................###.#.####
##.....######.......................................##..................#................####.................................##
###...######......................................####..................................#######..............................###
############......................................#####......................................###..............................##
###########....................##...............#########.#..................................##..............................###
###########........#.#........###...............#############................................##..............................###
#########.........######.......................####.#.######.................................#...........................#...###
##########..........#..........................##.....######.................................#..........................####.###
#########.....................................#.#......###...................................#..........................########
#########.................................#.#.#.......####.........................................###..................########
########.................................##.###......####...........................................##....................######
########..................................#.###......###............................................###......................###
#######........##...........................####.....#................................................#.......................##
#######........####............##.............##......................................................###.....................##
######..........######.#........#.............##.......................................................##..............##.....##
######...........#########......##............##......................................................####...........######..###
#####............########........#...........####...................................................#.#####.........############
######.........#########.........#..........#####....................................##............#########.........###########
##.##...........######......................######....................................#.###........##########.........##########
#..###............#####...................#.#####.......................................###........##########.........##########
#..................####..................##.###.......#.................................##..........##########..........########
#....................####.............#####.##........#.............................................#########..........#########
##.....................##.............#####...........#..............................................#.###.............#########
##.......................................#..##.......................................................................###########
###..........................................##......................................................................###########
##..........................................####...................................................................#############
###.........................................####.................................................................###############
##.......................................##.#####.......................................##...........##..........###############
###......................................#...#.#........................................##...........###.........###############
##.......................................#...............................................##...........##..........##############
###......................................................................................##...............................######
##..........................................................................................................................####
###.............................................................#..........................................................#####
##......#............#........................................####..........................................................####
##.....####..........##...............................#.......####..........................................................####
#......#####.........##..............................##......#####.........................###...............................###
##.....###...###......##.............................##.......#.#...........##............#####......##......................###
#...........#####.....##..............................#....................#####.........######......#.......................###
##...........###.......##.....###...........................................#####.......#######......#.......................###
#.............#.........#....#####.........................................######.......######...............................###
##............................#####.........##..............................######......######..............................####
#............................#######......#.##..............................######......#####..............................#####
##............................######.....##.##..............................######........................................######
##.............................#.#.#.....##.##...............................######...........####.........................#####
###......................................##.#.................................#####.........######........................######
##.............................................................................######......######............................###
###.............................................................................#######.########..............................##
###..........................#.......................###.........................######.#######........................E......##
####...#....................####.......##..........###.................#.........######.#.######...............................#
##...####.S..................###......###..........#####..............###.........#####...#####...............................##
##.....##.....................###......##.........####.#.#....##......###..........##.......####.....##........................#
##.............................##.................####...########......###.........###......###......##.......................##
#...............................###................##....#######......................................#......................###
##................................#...............##......#######..................###......................................####
#.................................###..............##.....#######..................###......................................####
##.................................##......................#######.............######.............................####.......###
#..................................###......................#######...........#####............................##########.....##
##..................................#.........................######...........###....................##.#...#####.#.#.###....##
#..............................................................######..........##....................########.##.......###....##
##.............................................................########..............................######..............##...##
##..............................................................#######..............................######.............########
##............................................................#########..............................####................#######
##..........................................................#.########................................###.................######
##........................................................#########...................................##....................####
##........................................................#######......................................##.##..................##
##..........................................................#.#.......................................######...................#
##..............................#......................................................................####...................##
##.............................####...................................................................####.....................#
###............................####..........#..................................#......................####...................##
###............................#########.#...#................................#####....................###....................##
###............................###########...#.#..............................#####.....................###..................###
###............................############....#............................########....................##...................###
###.............########.##################..###............................######...........#..........###..................###
###..............##########################.#####........................#####..............####.........##...................##
##.................########################.######.....................#####...............#####..............................##
###................########################.#########..........#.......####................######..............................#
##...................######################...########.......#####.......................########.............................##
###....................#.##################.....####..........#####.....................##########............................##
####......................######.########......###..............##......................#########............................###
#####......................###.....#######.....###......................................##########...........................###
######......................###.....######....###.......................................#########...........................####
#########..................####......##############.....................................#########...............#...........####
#########........#..........###.......#############.....................................#######...............####..........####
########.......#####.........#.........############.....................................#####................######........#####
#######........#######..................######...........................................##...................#####........#####
##.####.........######..................#####...................................................................#.#........#####
##...##...........#####...........##.....###................................................................................####
#.....................#..........####..................#####........................................................##......####
#................................###...................#######......................................................##.......###
#..............................#.#.....................######......................##................................##......###
#.............................####......................######............#......####................................##......###
##............................###.......................#####............###.....######.##...................................###
#.............................####.......................#####...........####....######.###..................................###
##............................####.......................#####...........###.......####.###...................................##
#............................######.......................#####..........###........###.##....................................##
##...........................#######.......#.#.............#####.#.......##...........#.#..............#.##...................##
##.........................####.#####......####.............########....###............................######..................#
##.........................####...####......###..............####.##....###..................##........#######................##
###.......................###.....####........#...............#.........###................####........#########...............#
##........................###.....####......................###.........###..............######.........###.#.#...............##
###.......................#.......###.......................##..........###.............#######..............................###
##................................###......................###.........####...........#.#######..............................###
###.........###..................###.............##.........#........#####..........###..######.............................####
##..........####.................###............###.#..............######...........#.....#####.............................####
###.........###..................##.............#####.............#####............###.....##########.#....................#####
###..........##...............................#######.............##...............##.......############..................######
#####.#.#................................##########...............................####......############..................######
##########...............................########..................................##.......#############................#######
##########.......................#.................................................###......#############................#######
###########......................##................................................###......################............########
############.............#.....###..................................#.......##.....#####....##################...#.......#######
#############..........#####.#.###........................#........####.....####.#######...########################....#########
##################.#.#############.........##########.#.#################.###########################################..#########
################################################################################################################################
