################################################################################################################################
###############...############################..........#############...###################..##############..###################
##############.....###..............###..####............##..##..........#####.........###......#####..###.....####.......######
#############.............................##..............................####.........##.........##............###........#####
###.#########............................###...............................###...........................####.........##...#####
##...########..............###...........##.................................##......#...................######.....#############
##......#####..............###..........###.................................##.....####..............#########.....#############
###.......##................#...........##...................................#.....#####............###########.....############
####............##.....................###...###....................................#####.......#########...####.....###########
#####...........###...................###....###.....................##..............###.......#########.....#####....##########
#####............###..................###....##......................###......................###...#####.....####....##########
######...........###....#.............##.....##....##................###......................#......####.......##....##########
######...........###....##...................##...####..............####......................#......####............###########
######.................####......................####..............######...........................#####...........#####...####
####...................####......................####.............#######..........................######............#.......###
###...................#####...............#......#####............#####.#..........................##########................###
##.....######.........#####.......###.....##......#####............#...................................########...............##
##....########.......#######...######.............######...............................................########.........#......#
##....####.####.......######..########.............#####.............#..................###.......##....##.............###.....#
##.....##...###........####...##..###...............####............###................####......###..................###.....##
###....#....###........###.........##..........##....###...........######..............#####..######.................###.....###
###.........####........##..........#..........##....####........########..............###########...................##......###
###..###....####........###........######.............####.......#######......#####...###########.............................##
###...##.....###..........##......#######..............###........#####......###################..............................##
##.....##....##...........##.....########.........................####......###################...............................##
##......##.................#.....#######...........................###......##########..#######..............................###
###....###......................#######..........##................###......#########.....#####.............................####
##########.....................#######..........####...............###........########.....#####...........................#####
#########......................#######.........#####...............##...........#######.....####............................####
########.......................#######.........#####................#............#####........#.............................####
#######.....##.................#######.........#####........................................................................####
#######....####.......####...#########......##..####....................####................................................####
#######...#####......################......###...###...................######..............####...###........................###
##..###..######.......##############........#.....###..................######..............###########.......................###
#........###...........########....................##...................########............###########......................###
#.........##............#####..........#...........##...................########............###########.......................##
#..........#............###..........####.................##............########............###########........................#
##........###............#........#######.................###..........#######..............############.......................#
##.........##..................###########................###......########...................#########.......................##
##.........#.............#....###########..................##....########..........................####.....................####
##......................###....#########.........................######.............................######.................#####
##.............##.......###.....#######.........................###..................................######................#####
###...........####.......#.......#####..........................#.....................................######..........#....#####
####..........######............#####..................................................................#####................####
#####..........#####...........######................................................##.................####................####
########......................#######...............................................####..........##.....#####...............###
###..####......................######.....................................####.....######.........##.....#####...............###
##....####......................####......................................#####...#######...............#####.................##
##.....###......................###....................................#########..#######..............######.....#............#
#........#......................###....................................########...##.####.............#######....###...........#
#...............................##.......###...........................######.........###...........########....####...........#
##.....................S........###.....####............................#####.........###.........#########....#####..........##
##...............................###...#####.............................#####.........##.......##########....#######.........##
###..............................####..######.............................###########..........#####..........#########......###
####..............................###...#####....##........................##########.........#####.............#######.....####
##................................###....###.....##......................#....#######.........#####..............######.....####
#......................................................................####....#####..........#####..............#####.......###
#................................###...........#......................#####.....###...........#####..............####.........##
##..............................####..........##......................#####....................####..............####........###
##.............................#####................####...............###........#.#..........####.........#....####......#####
##............................#######........#.....################.............#####...........##.........###...####.....######
###..........................###.#####......###....#################..........#######...........#.........###...#####.....######
####.............####.......####..#####....#####..##....############.........######.......................##....#####......#####
######..........#################..#####...########......############......#######.......................##....#####........####
######.####.....############.####..#####..#########......########################..........#....##.......##.....#####.......####
####..######...############....#...###..##########.......#######################..........###..###......#####.#.###..##.....####
###....######..###########........###...#######..........####...######....#####..........#########.....########.....###.....####
###.....#####...#...#####........###....####.............###....#####....................#########...##########.............####
###......#####.......###........####....###.............................................#########...##########..............####
###....#...###...................##.....................................................#########...###...###................###
##....###..###................................................................................##....###.......................##
##...###...####.........................................................###.........................###..................###...#
###..##....####...##............##.....................................#####........................###...........###########..#
###........####...###...........###.....####..............####........######.......................###...........############..#
####......#####....###..........###.....#####...........###########..#######..................#.....#............#####.#########
######.....####....##............##......#####.........####################...................##.................####....#######
#######....####....###...................######........####......##########....#..............##..........#..##.#####.....######
########....###...###...................#######....................#######....##..............##.........############.......####
########....###..####..................########.....................####.......#..............#.......#...###########........###
########....#########.................#########......................##...............................#...###########.........##
###.........#########..............############.............###......................................###..#####..####.........##
##.........###...#####............#############.............###..................................##..##...####................##
##........####....#####..........#####..######......###.....###.................................#######..####................###
#.........###.....#####..........####.......................###................#.................#####...###................####
#..........#.....#####............##.........................###...............#..................####...##....#####.......#####
#................###.....#.....................##.............##...............#...................####.......#######.....######
##...............##.....###...................#.....................................................###........#####.....#######
###............###......###..................#....................#......##.......######............####........###.......#..###
###...........###.......###......................................###...#####....########...........####......................###
##...........####........#.......................................####.#######..#########..........####.......................###
##.........................................#......................##.##################.........#####.................#.....####
##....................#............###....#...........................##############...........######................###....####
##...................###..........#####.###............................####.#####.............######.............##.####....####
#....................####........##########...........................####...###..............##................########....####
##...........###......####......##########...........................####.....#.....................##..........########.....###
###..........###......####.....##########...........................#####..........................######.......#########.....##
#####........###.......####...##########.............................#####...........####..........#######......#########.....##
######.......##.........###..#####.....................................####.......###########.....#######......####..####.....##
#######.................##########......................................###......#############...#######......####............##
#######..................#########......###.............................###......###..########...#######.....####.............##
#######........................###.....####..............................#......###....######.....#######...####.............###
#######........##......#......####.#######.........................###..........###.....#....................##..............###
########.......##.....###....###...######..........................####.........###....##....................................###
########..............##########.....###...###.....................#####........###...###....................................###
########.............##########...........#####....................########.....##...####.....................................##
######..............###...#####..........#######..........#.......#########..........####....................................###
#####.............#####...#####.....#...########....#...........##########............###...................................####
#####.............####.....#####...###...#######...............######..................##..................##..............#####
#####.....................###########.......#####..............#######.............######...................#..............#####
####.....................#.....#####.........#####.....#.......########...........#######...................................####
##.........#............##.......##.........#######..###........#######...........#######...................................####
#.......#####..........##...................##########..............#.............######...........................####.....####
#......######.........##...................###########............................#####..........................######....#####
#......######.........##....................#########.............##...............####..............................##...######
##......#####..................................#####.............####................###........................#####......#.###
###.....#####...................................................#####................##..........................###..........##
#####....###....#..........##........................######.....#####......#.........#..#.....................................##
######...###..####........#####...............##....########....#####.....##........##................................##......##
#######.#####.####.........######.............###..########......####.....##.......###...##.....####.......##........####.....##
#################...........######.............###########.......#####.............####...................#####.....######....##
###########...##.............#####..............######.............###..............###...................######....######...###
##########...........#####.....###...............####......###.......................###...................######...#######.####
##########..........######......###.............#####.....#####.........###..........####....................####...############
###########.........######......###............######.....#####........#####.........#########.......#........###...############
############........######......####...........#######.....#####.....#######........##########......###.............############
#############......#######.....######.#........########....######..##########......###########.....E#######.........############
#########################################################.#####################..#############.###.##############..#############
################################################################################################################################
