################################################################################################################################
####..#..#.#########.##############################.#.#..#.#.#.####.#.#.##############################################.#########
##............####.....#.#.#.#.#.#.#####.#.##.##.#...............#.........####.##.#.#.####.#.##.#.############.#.##...#.#.#.###
##.............#.#..................#......................................#.#..........#.#.........#.#.#.#.#.#................#
#.............................................................................................................................##
##.............................................................................................................................#
#.............................................................................................................................##
###.............................................................#..............................................................#
##............................................................###.............................................................##
###....................................................#.......###.............................................................#
##...................................................###.......#..............................................................##
###...................................................###.....................................................................##
##....................................................#.#....................................#................................##
###...............................#.....................#....................................................................###
#..............................###..#...................#........................#............................................##
##...........................#######.#..........................................###..........................................###
#............................#####...#...........................................###.........................................###
##...........................###.................................................###..........................................##
#............#...............###....................#............................#####........................................##
##..........#####............#.#..................###.............................###.........................................##
#............####..................................###............................#####........................................#
##...........#####................................###.............................####........................................##
###............#....................................#.........#.....................###........................................#
##............##............................................####....................#.........................................##
###..........................................................####..............................................................#
###.#.......................................................###...............................................................##
####..........................................................##...............................................................#
####..........................................................#...............................................................##
###...........................................................#................................................................#
##..........................................................###................................................................#
###............................................................###............................................................##
##.............................................................#...............................................................#
####...........................................................#####..........................................................##
####................................................................#..........................................................#
#####...........................................................####..........................................................##
####................................#.............................####.........................................................#
####..............................###.............................###..........................................................#
###................................###..........................#.####........................................................##
####...............................#......................#.#...#..#..........................................................##
##.................................#......................###.#.#............................................................###
###......................................................######...............................................................##
##.........................................................####................................................................#
##..........................................................#.................................................................##
##............................................................................................................................##
#............................................................................................................................###
##............................................................................................................................##
#............................................................................................................................###
##............................................................................................................................##
#...........................................................................................................#.#..............###
##..........................................................................................................#####.............##
#..........................................................................................................########..........###
###..........................................................................................................#####............##
##...........................................................................................................######..........###
###.............................................................................................................#.#...........##
##................................................................................................................#..........###
##.................................................................................................................#..........##
#..................................................................................................................#..........##
##.................................................................................................................#...........#
#...S.........................................................................................................................##
##.............................................................................................................................#
#................................###..........................................................................................##
#..............................................................................................................................#
##.......#...................................................................................................................###
#.....######..................................................................................................................##
##.....###............##.....#................................................................................................##
##.....#.#.............###.###.................................................................................................#
##....................#########................................................................................................#
###....................#######...............#................................................................................##
##....................########...............#.#...............................................................................#
###.....................##.#.................#.#..............................................................................##
##......................#......................#..............................................................................##
#............................................................................................................................###
##............................................................................................................................##
#............................................................................................................................###
##............................................................................................................................##
#.............................................................................................................................##
##.............................................................................................................................#
##............................................................................................................................##
##.............................................................................................................................#
###..........................................................................................................................###
##............................................................................................................................##
##...........................................................................................................................###
#.............................................................................................................................##
##...........................................................................................................................###
##............................................................................................................................##
##...........................................................................................................................###
###...........................................................................................................................##
##...........................................................................................................................###
##.............................................................................#..............................................##
#...............................................................................#............................................###
##.............................................................................#..............................................##
##.............................................................................#..............................................##
#.............................................................................#................................................#
##............................................................................#...............................................##
#..............................................................................................................................#
###...........................................................................................................................##
##.............................................................................................................................#
###...........................................................................................................................##
###............................................................................................................................#
##.............................................................................................................................#
###...........................................................................................................................##
##.............................................................................................................................#
###..........................................................................................................................E##
##.................................................................................#.#.........................................#
#..................................................................................###........................................##
##................................................................................######.......................................#
#...................................................................................###.......................................##
##..............................................................................#.....#.......................................##
#..............................................................................##..............................................#
##.............................................................................................................................#
##............................................................................................................................##
##.............................................................................................................................#
####..........................................................................................................................##
###............................................................................................................................#
####..........................................................................................................................##
#####..........................................................................................................................#
####..........................................................................................................................##
######.........................................................................................................................#
#####.......................................................#................................................................###
#######...................................................#.#................................................................###
########..................................................####................................#.............................####
#####.#.#.................................................###...............................###..............................###
###.....#..............#..................................###................................###............................####
###....................###...................#..............................................####.............................###
###...............#.######.................###...........................#.##.#.#.#.#.......######...............#.........#####
###.............#.##########..............######.#..#............#.#.#.#.#############.#.#########.#.....#.....####......#.#####
#####..#..#.#.#################.#.#.#.#.###############.#.#.#.#.#####################################.#####.#########..#########
################################################################################################################################
