################################################################################################################################
###....................................................................................................#########################
###.#.#####....#####.############................#######......###.##########.............####......###.##############.##########
###.#.####......####.##########..................#######.....##.........####.............####.......##.############.....########
###.#.###..............#######....................S#####......##.........................#####.......#.############.....########
###.#.##...............###.........................#####.....##.........................######.......#.###########........######
###.#.#..............................................###.....###........................#####..........######.#.#..........#####
###.#.......#####....................................###.....##.......................######...........####..................###
###.#......######.............................................#...............###.....#####............#####.................###
###.#.......#####.............................................................####.########............####....................#
###..........###..............#................................................############............#####..................##
###.#.......................#####...###.........................##.............############............#####...................#
###.#.....................#...##########..........###..........####.............###########.............####..................##
###.#...................#####..#########........#######........#####..............##########...........######.................##
###.#.#.................###......#######.......#########........##########..........####.#.###..........####.................###
###.#.#................###.......#####........########.#.#.........#########...............###.........#####................####
###...#...........................#.........#######......#..........#########...............##.........#####........###.....####
##...............#....##........##..........#####......#.##..........#######...............##.......##.###.........###......####
###............#####.###.....#######.......####.......##.##...........#######..............####.....##.#...........###......####
##...........#######.#####.#########.......###........##.###...........#####..............############.#.....................###
##..........########.################.................##.##............#######............############.......................###
##.........#########.###############...................#.###...........#######...........####..#######........................##
#..........#########.##########.#.#......................###............###########....#.##......####...........#.............##
##.........#########.#...................................###.............##################.......####..........###...........##
#..........#########......................#..............###.................#############.........##..........####....#......##
##.........####.........................####..........##.##....................###########......................#########.....##
##........#####........................####...........##.###.....##............###########.....................###########....##
###........####..................#.#.#####...........###.##......##.............#########.......................##########....##
###........####................##########............###.###..............#....##########......................###########....##
###.........####...........#############.............###.###.............###############........................#########.....##
###..........##..........###############.............###.####............###############........................#######.......##
##.....#.....#..........################..............##.####.............#############.............##..........#####.........##
#.......##.#.#.........##################.............##.#####..............##########............####..........####..........##
#........######.......####################.............#.#####.##..............#######.....#......####...........#.............#
#........######.......######################...........#.########................####.....##.....#####.........#.#............##
##.........######....#####..#######....#######...........#######................#####......#.....#####.......###......##.......#
##.........######.#..###......###........#####...........#####................#.#####............#####.......####.....##......##
###.#.......#####.##.##......####........######..........######.............########.............#####.#########......###......#
###.#.......####..##..........##...........####........#.#####.............#########.............#####.##########......#......##
###.#......#####.............###...........###.........#.#####............########................####.##########.............##
###.#......######............##.............##........##.#.##...........##########................####.##########.............##
###.#....##########........................###........##..............####........................####.###########..........####
###.#.##.###########.......................##........###............######.........................#......#######...........####
###.#.##############......................###........###...........###......................................#####...........####
###.#.#############.......................###.........##...........#.........................................###............####
###.#.....########.......................###.......................#...........................................#...........#####
###.#.......####..........................##...............................................................................#####
###............#.......#..................#......................##...........................###..........................#####
###............#.#.#.#####.............................#.........#............................########.##..................#####
#..............#####.####..............................#.##.....................................######.###.................#####
##...........#######.#####............................##.##.......................................####.###.......####....#######
#............#######.####.............................##.###........................................##.####.......##############
###........#########.####.............................##.###........................................##.#####.....###############
###......###########.###........###..........####......#.###.........................................#.#####..................##
###.##.##########.##.####....######..........######......###.........................................#.######.................##
###.###########......###...######............#######.....####................########.....................###..................#
###.#########.#..........#######..............#.#.###.......................#########.........................................##
###.#########............######...................###.......................##########........................................##
###.##########...........#####......................#.......................##########.......................................###
###.##########.............###......................##.......................##########....................##................###
###...#########..............#......................###.......................#########..............#.#.####................###
###...#########..............##.....................###.......................#########.............##.######................###
##....##########.....#.......##....................#####.......................########.............##.######.................##
###...##########.....##......##....................####.........................########.............#.######.................##
##....#########....#.##......##...................#####..........................#######.............#.######................###
###..####..........#.##............................###...................###......########.............######................###
###.###............#.##.....................###....####..................###.......#######.............######................###
###.####.............##.....................####....##...................####.....#########...###...........#######.......######
###.####.............###.....................##......##...................###.....########....####..........########.......#####
###.#####.............##....................####....###.....................#....#########...#####...........#######........####
###.#.#..............###....................#####....##..........................#########....#####........##########........###
###.............#.....###..........#......#######..####...........................########.....####........##########.........##
###.............###..###..........####....#############...........................#########......###.....#############.......###
###............#####.####.........#####...#############............................########......#####.##############........###
###.#...........####.####.........######.#####.#.#.###..............................########.......###.##############.......####
###.##.........#####.#####.........###########........................................#.#.##.......###.##############.......####
###.##.........#####.#####.........##########.............................................###......###.##############........###
###.###.......######.######........###########.............................................###.....###.##############........###
###.###.......######.######........##########..............................................####....###.##############.........##
###.#####...########.######........###########.............................................#####..####.##############.........##
###.#####.#.########.######.......############.............................................#########...########.####.....#...###
###.################.######........#############.#.........................................########.....######....###....#######
###.##########...###.#######........############.#................######...................#######......#####....###......######
###.########.......#.######...........##########.#...............#######............##....########......####......###......#####
###.##.............#.#####...............#####.....#.....#......#######...............###...######......####.....###.......#####
###.#................####..................#......###.##.##.....#####...................###....###......####......###......#####
###.#................##...........................######.###..######.....................#.....#####..######.....####.....######
###.##...............###..........................######.##########..............................###########.....######.########
###.###..............##........###.................#####.#########..............................############.....###############
###.###..............###........###................#####.####.#.#.................................########......###########..###
###.###..............###........###..................###.####.......................................###..........########.....##
###.##...............#####.......###..................##.###.......................................................######.....##
###.#................#####......######.#.#.............#.###.......................................................#####......##
###.#...........#.#..######......###########...........#.####........................................................###......##
###............#####.######.....#############..........#.####........................................................###......##
###.#..........#####.#####.......#############.........#.######..E....................................................#.......##
###.#...........####...####.....##############.........#.######.................................................##............##
###.###.........###.....##......#######.....#............######................................................###...........###
###.###.........###....####....#######...................#######.........................................#....####...........###
###.#####........###...###.....#######....................######.........................................#...####............###
###.#####........##########.....######....................######.........................................######..............###
###.######........##########...#######................#...######.........................................#####...............###
###...###..........##########....####...............####.#####............................................##..................##
###...###...........###########.....#..............#####.#####...........................................##..................###
###..###............###########...................######.###.............................................##...................##
##########..........############.................#######.###.............................................###..................##
##########........#############..................#######.##..............................................##...................##
############.#...###############.................#######.##..............................................##...................##
################...############..................#######................................................###......##...........##
##################..############...................#####................................................###......####.........##
#########..................####...................######......###......................................#####...######.........##
#########..................#####...................#####....#.###......................................#####...#######........##
#########..................####..................#######..########....................................######.#########........##
#########........................................#######.#########....................................#####...##########......##
#########.......................................########...####.#.......................................#.....##########.....###
####.#.##......................................########...####..............#..................................#########......##
####...##.....................................#######.....###.............###...................#..............#####.#........##
##............................................#####......###..............###..............######..............####......###.###
###...........................................#####......###............#####.............######...............###........######
###.#.#........................................####......#............#######............#######......#........##........#######
#########..................#####................####...###............#######...........#######.......###......###......########
#########..................######...............####.#.##..............######..........#######........###......##......#########
#########..................#######...............########..............####...........#####............####....####...##########
########.....###...###############..............########................###.........#####.............#####...##################
########....####.#..###############..............########...............##..........#####..............#########################
########....################################.#.###########.......#.#.#.#####.....#########...........###########################
##########################################################.#.#.############################........#############################
################################################################################################################################
