################################################################################################################################
#####...#.#.##.#.#..........#.#.######.#.........#.###.#......#.###########.#.#.#....#.#....#.#............#.#.#.#........######
#######..........................#.###..........................#######.#.#................................................#####
#####............................#................................###.......................................................####
####.............................................................#..#.........................................................##
###................................................................#.........................................................###
##.............................................................................................................................#
##................#....................S.......................................................................................#
#................#.#...........................................................................................................#
##.............................................................................................................................#
#..............................................................................................................................#
##.............................................................................................................................#
#..............................................................................................................................#
##.............................................................................................................................#
##.............................................................................................................................#
###............................................................................................................................#
####..................................#........................................................................................#
##...................................#.........................................................................................#
##....................................##.......................................................................................#
#..............................................................................................................................#
##.............................................................................................................................#
#..............................................................................................................................#
###............................................................................................................................#
#..............................................................................................................................#
##.............................................................................................................................#
#..............................................................................................................................#
##...............................................................................#.............................................#
#...............................................................................#..............................................#
#................................................................................#.............................................#
#..............................................................................................................................#
#..............................................................................................................................#
#..............................................................................................................................#
#.......................................................................................##.....................................#
#........................................................................................#....................................##
#....................................................................##.................#......................................#
#........................................................................................#....................................##
#....................................................................#..................#......................................#
#....................................................................#...................#....................................##
#.....................................................................#.......................................................##
#............................................................................................................................###
#............................................................................................................................###
#...........................................................................................................................####
##..........................................................................................................................####
#............................................................................................................................###
###...........................................................................................................................##
##...........................................................................................................................###
###............................................................................................................................#
#...........................................................................#.................................................##
##........................................................................##...................................................#
#.......................................................................##.....................................................#
##.............................................................................................................................#
#..............................................................................................................................#
##.............................................................................................................................#
#..............................................................................................................................#
##...................................#........................................................................................##
#....................................##........................................................................................#
##.............................................................................................................................#
#..............................................................................................................................#
##.............................................................................................................................#
###............................................................................................................................#
##.............................................................................................................................#
##.............................................................................................................................#
###............................................................................................................................#
###...........................................................................................................................##
#..............................................................................................................................#
##.............................................................................................................................#
#..............................................................................................................................#
#..............................................................................................................................#
#.............................................................................................................................##
#..............................................................................................................................#
##...........................................................................................................................###
#...........................................................................................................................#.##
##............................................................................................................................##
#............................................................................................................................###
#..............................................................................................................................#
#.............................................................................................................................##
#..............................................................................................................................#
#..............................................................................................................................#
#.............................................................................#...............................................##
#...........................................................................#..#...............................................#
#............................................................................####.............................................##
##...........................................................................###...............................................#
##..........................................................................#####...............#.#...........................##
###..........................................................................###.................#.............................#
##.............................................................................................#.#.#..........................##
###.............................................................................................#.#............................#
#...............................................................................................#.#...........................##
##................................................................................................#..........................###
#............................................................................................................................###
#....................................................................................................................#.........#
#...............................................................................#...................................##......#.##
#...............................................................................#...................................##.......###
#................................................................................#..................................###.......##
##..................................................................................................................##.........#
#...................................................................................................................####.......#
##.................................................................................................................####........#
#...................................................................................................................#..#.......#
#.....................................................................................................................#........#
#..............................................................................................................................#
##.............................................................................................................................#
##.............................................................................................................................#
##............................................................................................................................##
###............................................................................................................................#
##...............................................#........................#...................................................##
###..............................................#.#.#....................#.#.................................................##
##................................................#.#.....................##..................................................##
###..............................................#.............................................................................#
#.............................................................................................................................##
##.............................................................................................................................#
#..............................................................................................................#...............#
##..............................................................................................................#..............#
#..............................................................................................................#...............#
##............................................................................................................#.###............#
#.............................................................................................#####.............##.............#
##..........................................................................................##########........##.#.............#
#............................................................................................########..........................#
##..........................................................................................####.#.#.#.........................#
#............................................................................................#.#...............................#
###............................................................................................................................#
##............................................................................E................................................#
##.............................................................................................................................#
#..............................................................................................................................#
##............................................................................................................................##
#.............................................................................................................................##
#...........................................#...........................#....................................................###
##......#.#.....#.........................###.#........................####.................................#...#.##........####
##......#####.#.#.#............#.#......#.#####.#...#.#.#.#.#.#.#.#.#.#####.#.....#.#......................##########.#.#.######
################################################################################################################################
