################################################################################################################################
###################################################################################################.############################
###################################################################################################.############################
###################################################################################################.############################
###################################################################################################.############################
###################################################################################################.############################
###################################################################################################.############################
###################################################################################################.############################
###################################################################################################.############################
#########################################################################################.#########.############################
#####################################################################################.........##################################
###################################################################################.............################################
##################################################################################...............###############################
#################################################################################.................##############################
################################################################################...................#############################
################################################################################...................#############################
###############################################################################.....................############################
###############################################################################.....................############################
###############################################################################.....................############################
###############################################################################.....................############################
##############################################################################.......................###########################
###############################################################################.....................############################
###############################################################################.....................############################
###############################################################################.....................############################
###############################################################################.....................############################
##########################################.#####################################...................#############################
######################################.........#################################.............E.....#############################
####################################.............################################.................##############################
###################################...............################################.........S.....###############################
##################################.................################################.............################################
#################################...................#################################.........##################################
#################################...................#####################################.######################################
################################.....................###########################################################################
################################.....................###########################################################################
################################.....................###########################################################################
################################.....................###########################################################################
###############################.......................##########################################################################
################################.....................###########################################################################
################################.....................###########################################################################
################################.....................###########################################################################
################################.....................###########################################################################
#################################...................############################################################################
#################################...................############################################################################
##################################.................#############################################################################
###################################...............##############################################################################
####################################.............###############################################################################
######################################.........#################################################################################
##########################################.#####################################################################################
################################################################################################################################
################################################################################################################################
################################################################################################################################
################################################################################################################################
################################################################################################################################
################################################################################################################################
################################################################################################################################
################################################################################################################################
################################################################################################################################
################################################################################################################################
################################################################################################################################
################################################################################################################################
################################################################################################################################
################################################################################################################################
################################################################################################################################
################################################################################################################################
################################################################################################################################
################################################################################################################################
################################################################################################################################
################################################################################################################################
################################################################################################################################
################################################################################################################################
##################..............################################################################################################
################################################################################################################################
################################################################################################################################
################################################################################################################################
################################################################################################################################
####################...........#################################################################################################
####################...........#################################################################################################
####################...........#################################################################################################
####################...........#################################################################################################
####################...........#################################################################################################
####################...........#################################################################################################
####################...........#################################################################################################
####################...........#################################################################################################
####################...........#################################################################################################
###################################################################################################################.......######
###################################################################################################################.......######
###################################################################################################################.......######
#########################...........###############################################################################.......######
#########################...........###############################################################################.......######
#########################...........###############################################################################.......######
#########################...........###############################################################################.......######
#########################...........###############################################################################.......######
#########################...........###############################################################################.......######
#########################...........###############################################################################.......######
#########################...........###############################################################################.......######
#########################...........###############################################################################.......######
#########################...........###############################################################################.......######
#########################...........############################################################################################
#########################...........############################################################################################
#########################...........############################################################################################
#########################...........###########.......##########################################################################
#########################...........############################################################################################
#########################...........############################################################################################
#########################...........############################################################################################
#########################...........############################################################################################
#########################...........############################################################################################
#########################...........############################################################################################
################################################################################################################################
################################################################################################################################
################################################################################################################################
################################################################################################################################
################################################################################################################################
################################################################################################################################
################################################################################################################################
################################################################################################################################
################################################################################################################################
################################################################################################################################
################################################################################################################################
################################################################################################################################
################################################################################################################################
################################################################################################################################
################################################################################################################################
################################################################################################################################
################################################################################################################################
################################################################################################################################
################################################################################################################################
################################################################################################################################
################################################################################################################################
