################################################################################################################################
#########.#.#.#.##.#.################.#.#.#.############........######################.#.#.#.###################################
#####................########................######.............############.#.....#...........###.###############.#.#.#.#######
###....................####...................####...............##########....................#.#..#############.........######
###....................#.......................###...............#####.###.........................#####..#######..........#####
##.....................#.......................###..............#####...###........................###....######..........######
##...................##......#................####.............######.............................####.....#####..........######
##...................###....###............#######.............#######......#.#...................####......##.............#####
##................######.....###.........#########................###.....#####...................###.......................####
##................#######....###........#########.................#.......####....................###...................#....###
##................######......###......##########........................####.....................##...................##.....##
##.................######.............##########.........................###..........#...............................###.....##
##..................#####...............#.#.###...........................##.........####.........##.................###......##
##...................####................................................###........####...........####.....#.#########.......##
##....................#...................................................##.......#####..........####...#############........##
##.......................................................................###.......####............###...############.........##
##.......................................................................###......####............#############.####.........###
#..........................##.........................................######.....####.............############....#...........##
#............##..........#####.......###..............................#####......###...............##########...............####
#............##..........######....######..............................####......##................#########.................###
#............###........#####.....#######..............#.................#...........................####...............###.####
#..............#........#####.....######.....#.........###...............#.............................................###....##
#.............###......#####.......####....###.........###..............#..............................................###....##
#..............##......####.........#.......##.........#...............###.............................................##.....##
#............######...#####.................#..........................####........................................#.#.#......##
#.....###########...#.####................#...........................#####.....................................#########.....##
#.....########....#########...............###.........................######...................................##########.....##
#....####.####.....#######...............####.........................#####....................................#########.......#
##...#....###......########...............#####......................####............###........................#####..........#
##.#.#.....###......######................######....................###............#####..........................#............#
####......###...............................#####..................................#####...............####....................#
####.......###.............................##########..............................###.................#####...................#
##.........####....................###......########.....................................................#............#.......##
##.........######.................#####....#########.........................................##......................###......##
#..........########................###.....####...##.........................................#........................#......###
##.........########................###.....####..##..........................................................................###
#...........########......................####....##.........................................................................###
##...........#######......................###....###.........................................................................###
##...............####.......#.............####....#..........................................................................###
#................####......###.............##................................................................................###
##................####.....###...............................................................................................###
#................#####......###.......................................................#.....................................####
##.S..............#####.....##.......................................................####.....#........................#########
#.................#####.....###......................................................############.....................##########
##.................####......##......................................................#############......................########
##.................####......##.....................................................##############......................########
####.##..............##......###.....................................................##......######.......................######
#########......##.............##.....................................................#.........####........##.............######
#################.............###......................###.#.........................#.........#####........#........##...######
################...............#...............#.......#######..................................###................#####...#####
###############................................###....########.................................#####.#.###........######...#####
##############.................................##.....#########..............................#...#...######.......#####....#####
#############....................................#.########.###..............##............###........######......######...#####
#############.......................................######...###.............##...........####.........######...########..######
############.......................................#######.#.##.............###......##.#.####..........########################
##########............................##.............#######.#...............##....##########..........###############.#.#######
########..............................##.............#####...........##.....####....#########...........############......######
########.............................###..............####...........###.....####.##########...........######....#.........#####
#######.............................................#####......#.#...#......#################..........####.................####
########............................................#####....#######........##################.........####..................###
########.........##.#..............................#####.....######..........##################.........#.....................##
#########........######.............###............####.....########.........#########...########.............................##
######.##..........######...........##............####......#######..........########......#####...............................#
####...###............###...........#.......................##.#####........########.........#................................##
####.....#.............###..........#.............................##........########...........................................#
####....####............##..................................................########..........................................##
###......#####..........##.#.................................................######............................................#
###.....########.........###..................................................................................................##
###.....########...........#...................................................................................................#
##......########..............................................................................................................##
###......#.#.##................................................................................................................#
##...........#................................................................................................................##
###...........................................................................................................................##
##...................................................................................................#.......................###
##.................................................................................................####.......................##
##.#..........##..........##........................................................................###.......................##
######.......###.........####...................................#............##................................................#
########.....####.........###..................................####..........##...................................###.........##
####.###.....####.........##...................................#####.........###..................................###.#........#
##...####.....###........###.....................................###.........###..........................#........#####......##
##.....#......##.........##........................................#..........###........................####......#####.......#
#......................###....................................................###.........................#####....######.....##
#....................#####.....................................................###...........................####.#######.....##
#..................#####......................................................###............................############......#
#.................######....................................#..................###............................##########.......#
##................######..................................####.................####...........................##########.......#
##................######..................................#####................####...........................#########........#
###................#####.................................#####...........#......###...........................########.........#
####..............#####...................................####...........##.....###.......###.................########.........#
####...............####..................................###.............###.............#####.................######..........#
#####......##.......##....................................##..............##.............######........#.........######.......##
#####......###......................................#.#...#................#............##################........#####.......##
###.#.......##...........................#..........###..................................#################.........#####.....###
###.....................................###.......#####...................................#######.########..........#####....###
#................................##.....####......###.....................................####....#####.............######..####
##.......................##.....####...#####.....####...............................................###.............############
#........................##......###...#####.....###................................#................................###########
##........................##...........###.......###..............................####................................#.#.#.#.##
#........................##.......................##..............................####........................................##
##...##..................###.......................#.#...........................######........................................#
##.###.................####........................###...........................######.......................................##
#######...............###.###......................###...........................#####......................................#.##
#######.......##.....##...###......................##.............#...............###......................................#####
#######........#......##...###.....................##............###.......................................................#####
######...................#####....................###............###........................................................####
####...................#####................##....###.............###...................#....................................###
###....................###..................########.............#####.................###....................................##
###...................####................##########..............#####................####....................................#
###...................###...............##########...............######.................###...............##..................##
###..................####........###.....#.#.#####..............#######.................###..............###...................#
####.................####..#.#.#####.........####...............###.#....................##..............#####.#.#.............#
####.................###############............#..............####.....................................##########............##
####..................############.............................##........................................###.######...........##
####....................#.#.######.....................................................................####....#####..........##
####........................#####......................................................................###.....####...........##
###...........................####..........................................#..........................#.........#............##
###..........................####.........................................####.............#.............................#...###
##............................###...................##..................######.............#.........................E..##...###
#...........#................###.....................##................#########............#..........................###...###
##...........................###.....................#.#.#.............####.####......................................####...###
#........####...............###...........................##..................###....................................####.....##
##.......###...............######.........................###.................###...................................######...###
##......#####..............######.#.#..........................................##................................#.######.....##
##.......###...........###..##########...............##.......................#####.###........................###########...###
###.....######.........##....#########..............##......................############.....................###############.###
###......#####.......######.###########.............###...........#........################.................####################
#####..#########.#.#.###################...####...######........#####....####################......#.#.#.#######################
################################################################################################################################
