################################################################################################################################
#####...########..####.......########......######......####.####.#####..#####...####......#####..####.....#######....##....#####
#####.....##.................########........##........###.........###..##.......................##.......#######...........####
#####.......................###..####...............................##.................##................###.####..............#
##..........................###..##......###...........................................##...........##..##....###....##........#
#........###...........##................###.........................##...............###...........##..##...........###.......#
#.....######...........##..........................................####.........###...##.............................###.......#
#.....######...............##......................................####.........####.................##.................###...##
#.....#####................##....................................................###.................##.................####..##
#..................................................###....................................................##........##....##...#
##......................##.........................###...........##.......................................##........##....##...#
##......................#####......................##.....##.....##...........................................###........###...#
#..........................##.............................##.....##.............................##...........####........###...#
#................................................##....................####.....................##..##.......###..........##...#
##...#######...##................................##................S...####.......................####.....#####.........##....#
##...###.###..##..................................##..............##..............................####.....###...........##....#
##............##..................................##..............##...........................................................#
##.............###................................###.....##.......................................................##..........#
##.............###................................####..#####...............................##.....................##..........#
#...............#.............................##....##..#####.........##....................##.....................##..........#
#..............##...........................####.........##...........##.....##................................................#
#..............##........................######.......................#......##.......................................###......#
#.........................................##................##........##.....##.......................................###......#
#..###.....###............##..............##................##..##....##..............................................##..##...#
#..###.....###............##...........................##.......##.....##..........................##..#####..............##...#
##.........##.........##...#......##...................###....##.......##..........................##..#####.......###.........#
##.......###..##.....####.##.....###...................###....##.......##......##.....##...........##...##.........###.........#
##.......###..##....###.######...##.........##.........##..............###.....##....####...............##....................##
#...................##...#####..###..##.....##...##....###.............###...####....####...............##....................##
#.................###...........#######..........##....###.............##....#####......#...................####...............#
###...............##...............##.........................##...............###......#...................###................#
###................##..........................##.............###..............##.......##.....................................#
#..................##..........................##.............###..............##.......##......................##..#####......#
#..................##.........................................###.............###.............##.........#####..##..#####.....##
#...................#.........................................................##..............##.........##########...######..##
##.................##....................##..............................................................##...#####.....####..##
##.......##........##....................####..........................##...##..........##.......................##.....########
##.......##................................###.......................####...##..........##.............................#########
##......................##.##..............###........##.............##........................###.....................###.....#
##......................#####.........................##.......................................###............######...###.....#
##......................#####.......................................................###.....##................##..###..###.....#
#.......................##.........................................##..##...........###...####...............##....##...#......#
#..................................................................##..##.............#.######............####.........##.....##
#....................##............................................##.................#.####..............##..........###.....##
#..........##....##..##.........##.........##......................##.................#####........................####........#
#..........##....##.............##.........##........##...............................#####........##...........######.........#
#...##....##......#..................................##...............................##...........###......##..#####.........##
#...##....#.......####...##........................................##..............................###......#########.........##
#.........##..##..####...###........##.##....................##...###...##.........##..##..##......##.........#######..........#
##.........#####..##......##........##.##.............##.....##...###...##.........##..##..##..................####............#
##..........###...##.................................###................#...###........##........................##...........##
##................##........................##.......##.................#...###...##...##................##......##...........##
##................##........................##..........................##.#####..###..##.................#.....##..........####
##.......................###............##..............................########..###..##.......................#...........####
####..##.................###............##...................##....##......#####...#...###......................#..............#
####..##...........##....###............###..................##....####....####....##..###.....................##..............#
#####..............##...................###.........................####...........##.###..##..................##..............#
#..##..............#.............................................##..###..............###..##..................................#
#...###............#...........##.................##.........##..##.###..................####.................................##
##..###.......##...###.........##.................##.........##.....##..................###...................................##
##..###.......##....##.......##..................###.........##................###......##...................................###
#...##..............#####....###...###...........##...........................###....##.........................####.........###
#...##..............#####....###...###...........................##...........##.....##.........................####..........##
#...................##........##...##............................##..................##........................###............##
#......##.............................##.......................................................................................#
#......##.............................##................................##.....................................................#
#.....................##....#####......#................................##......###...........#..........................##...##
#.......##............##....#####......##..................##...................###...........##.................###.....##...##
#......###............................###..................##....................................................###.....##...##
##....####............................####.........................................................##.....##.......##.........##
##....####....##...............###......##.........................................................##.....##.......###.........#
#....####.....##..........................#...............................................................##........##.........#
#....###..................................#........##...............................................................######.....#
#....###..................................###......##.........................................................##....#######....#
#....##.............##....................###......##.........................................................###....##..###...#
#..####............###.....................##.................................................................###....##...######
#..####............##...##....................................................................................##...........#####
#..####......##...###...##...................................................##.....#####..................##.............#..###
#...####..################..................................................###.....##.##.....##...##...#####............###.###
##..########..###########...................................##..........##..##............##..##...##...#####............###..##
##.########...##....###........................##...........##..........##..##............##...............##.............##...#
##.######............##........................#####..##....................##..............................##.................#
#..#####.........................................###..##....................................................##.................#
#..##............................................##........##.........................##..##...##...........##.................#
#...........................###.................###.......###.........................##..##...##.............................##
#...##.......................##...........##....#############............................###........##.............###........##
#...##.............##.....................##.....############...........##........###....##.........##.............###........##
#...#####..........##............................############...........##........###..........................................#
#...######.........................................##...#####...................................###.............##.............#
#...########............................................##..##..................................###.............##.....##......#
#....###..##.................##.........................##..##...................................................##....##......#
#...####............##.......##....##.......##.......#####............................##.........................##...........##
#..#####............##.......##....###...##.##.......#####............................##....................##.............#####
#..#.........................##.....##...##..........##.....................................................##.............#####
#..#..............................................##.........................................................................###
#..##.............................................##.............................................##..........................###
#####...................................................................##.....##................###...........................#
#####...................................................................##....###.................##...##...............##.....#
#####.........................................................................##..................###..##...............###....#
#####.................##.............................##...##.....................##................##.........##........###....#
#####.......##........##.............................##...##.....................##........................#####...###.........#
#####.......##............................................##.................................###...........####....###.........#
##........................................................##.................................###............###................#
##.....................###................##..........##..##.............##.........##.......................##........##......#
##...........##.....##.###................##..........####...............##.........###......................##........##......#
#............##.....##..............##....##...........###...........................##........................................#
#...................##..............##.................###...........................###.##....................................#
##..................................##................###............................######....................................#
##..........................##......................###................................####....................................#
##.......##.................##......................##......................##.......................E......##.................#
##.......###........................................#.......................##..............................###................#
#..........###......................##............###....................##.................................###......###......##
##..........##....##.........##.....##......##...###.........#...........##.................##....##.................###......##
##...............###.........##.............##...##..........#####..........................##...###...........................#
##...............##..........#####..........#.................####......................#####..###.............................#
##...............##............####.....................................................####...##..............................#
##.............................####.....##.........................###...................##.........................###........#
##.........................###..........##........................####.................##........................######........#
##.........................###...................................................##...###..##....................###...........#
#..............##...............................................................###...#....##...##.............................#
#..............##...................................................##..........###...#.........##..........##.................#
#........##.........................................................###....###..##.................###......##................##
#........##.........##....####.......................................###...###.....................###......##...............###
#........##.........##....####......###...............................##...................##.......##.......................###
#..###......##......................#####.................................................####................###...#..........#
######.....###................##...######................................................#####................####.######......#
######.....####..####..##..##################.###..............####.........###....###..######........##.....############....###
################################################################################################################################
