################################################################################################################################
################################################################################################################################
######............##########..########.########################........##########...........#.#.#.#...#.#.#.#....###############
####.........................................###########...........................................................#############
###..................................................................................................................####...####
####...............................................................#..................................................##....####
####.........................................................................................................................###
#####................................................................................................................####....###
####.................................................................................................................####....###
#####.............................####......#......................................................................######.....##
####.............................#######...###............................................................###......######.....##
####............................#######.....#............................................###...............##....#######......##
###..............................######.................................................####................#....######......###
####..............................#.#...................................................######..................######.......###
###............#.........................................................................####...................#####.......####
####.........#####........................................................##.............#####.................######.......####
###...........###.........................................................###..............#....................####.......#####
####.........#####........................................................##...................................#####........####
###...........##...........................................................#....................................####.......#####
###..........###.............##................................................................................#####........####
##............#..............##................................................................................#####........####
###.........#####.####......####.............###..............................................................######........####
##..........#####.###........##............######.............................................................#.###..........###
##..........###.#.###.........#............#######...........#.#...............#............................#.#..............###
###...........#...........................#########..........................###............................#.................##
###........................................#########..........................###.........................###...##............##
####.......................................#########.........................####.........................##....###...........##
###..........................................#######........#.................###........................####..###............##
####......................##.....S...........#####.#.......###...............###..........................#......#............##
###.......................#....................###..........#.................##..............................................##
####.........................................................................................................................###
###..........................................................................................................................###
####.......................................................................................................................#####
###......................................................................###...............................................#####
###.....................................................................####.............................................#######
####...................................................................######...........................#####.............######
###....................................................................#####...........................######.............######
####....................................................................####...........................#######.............#####
###.....................................................................................................####................####
###.....................................................................................................#.#..................###
###........................................................#.#................................................................##
####.......................................................###...............................................................###
####......................................................######...........................................##.#...............##
####......................................................######..........................................###.###.#.#.#......###
####......................................................#######........................................####.#########.......##
###.......................................................######........................................#####.##########.....###
###......................................................................................................####.#########......###
##......................................................................................................#####.#.#.#####.....####
###....#.#...............................................................................................####................###
##.....###.............................#..........................................#.......................##................####
###...#####..........................#####...........#..........................###..........................................###
##....####............................###........................................###........................................####
###.....##............................#.#........................................#..........................................####
##......................#...............................................................................................########
##....................###...............................................................................................########
##.....................###.............................................................................................#########
##.....................#................................................................................................####..##
##.......................................................................................................................##...##
###............................................................................................................................#
###......................................##...................................................................................##
###......................##.............####...................................................................###............##
###.....................#####...........######.......................................................###.......###............##
###.....................#######.........##########..................................................######.....#####.........###
###......................########.......##########...................................................######.....###...........##
###.......................#######.........#########.................................................########.....#...........###
####........................######...................................................................########................###
###.........................#####.....................................................................#######...............####
####..................................................................................................######................####
###.....................................................................................................###................#####
####...................................................................###..............................#..................#####
###....#..............................................................####..............###...............................######
###....###..........................................................######.............###................................######
##....#####........................................................#######............#####.............................########
###....######.......................................................#####...............................................########
###...#######...............##......................................#####...............................................########
###....#######............#####.........................................................................................########
###....######.............#####..........................................................................................#######
##.......####............######..........................................................................................#######
###.......................#####............................................................................................#####
##............................#.............................................................................................####
###........................................................................................................................#####
##.........................................................................................................................#####
##.........................................#........................................................................#.....######
###......................................###......................................................................#####...######
####.....................................####........###..........................................................#####...######
#####...................................#####.....................................................................######...#####
####.....................................####...........#.#........................................................####....#####
####....#...............................####.............##.........................................................####....####
###...###.................................##.............#...........................................................#......####
###....##....................................................................................................................###
###...###....................................................................................................................###
####....#.....................................................................................................................##
####..........................................................................................................................##
####.....................................................#.#..................................................................##
####...............................................#.#.#####..................................................................##
####.............................................###########..................................................................##
####.............................................#########...........E........................................................##
####.............................................#######......................................................................##
####..............................................####........................................................................##
###................................................#.#........................................................................##
####...###....................................................................................................................##
####...###...................................................................................................................###
####...###...............................................##..................................................................###
###......................................................##..................................................................###
###......................................................#...................................................................###
###...........................................................##.............................................................###
##............................................................####.........#.#.............................#.#.#.............###
###...........................................................###..........#####...........................######............###
##..............................##...........................#####........########.......................##########..........###
###............................#.............................####.........##########......................###########........###
##..........................................................#####........###########.....................#############.......###
###...................................###...................######.......###########.......................###########........##
##....................................##....................######.......########..........................#.#.#...###........##
###....................................#......................####.......######...............................................##
##..................#.........................................#####.......###........................................####.....##
##................###...........................................#.........#..........................................####.....##
##.................###...................................................###.......................................#######...###
##.................###..................................................#####.....##...............................#####.....###
##....................................................................#######....###..............................######....####
##..................................................................#########.....#.................................#.......####
##................................................................##########...............................................#####
##.............................................................########....................................................#####
##.............................................................######.........................#...........................######
###..........................................###.......####..#######...................#.#..#####...#.#............#.#.....#####
#########.....#.#.#....###########...........####....################........#.#.#...#####################......#########.######
###########.########################.......#######.#############################################################################
################################################################################################################################
################################################################################################################################
