################################################################################################################################
####......................................................................................................................######
####.#######...####.............####.########################......###############.#############..............#####.........####
####.#####.......................###.######################........#############.....###########..............####..........####
####.######......................###.....#.#.############............######.#####......#########..............#####...........##
####...###.......................###............#######...............###...#####........#####................####...........###
###...#####.............#........###.............####........................#####.........####.....#.#........###.........#.###
####..####.........######........###............#####........................#####.........####...######.........#.......#######
####.#######........#####........###.............##..........................#####...........###.#######..................######
####.#######........#####........###.....##..................................#####.............#.#######...................#####
####.#########......#####........###.....##..................................#####...................###....................####
####.##########.....#####......#####......##.................................#####...................####....................###
####.##########.....#####......#####......##............##.#.#...............####.............................................##
####.##########....######.....######...................#######................###..............................................#
####.#########.....######......#####..................#.......................##.....................................#.#.......#
####.########.....######.......#####..................#...............................................####...........#.##......#
####.#######......######........####..................#...............................................#####.#.#......#.###.....#
####..#######.....##.#.........#####................................................................#######.#.#....#.#.####....#
####...######..................###...................................................###.........##########.#.#.#.##.#.#####...#
##.....#######................####..................................................###..........##########.#.#.####.#.#########
##.....#######...............###........................................#...........#####........#.#.######.#.#.####.#.#########
##.....########.............####......................................####.........######............######.#.######.#.#########
#.....##....####..........####................#......................######........######..............####.#.######.#.#########
##....##....#####.......#.####...............####...................#######.......#########.#..........####.#............#######
#....#........###.....###.###...............######..................######.........############.........###.#............#######
##...#...............####.###................####...................#######.......#############.........###.#............#######
##.##.................###.#............#.....#####..........##.###.#######.........###########...........##.#............#######
#####...................................#....####..............###.########.........######.###...........##..............#######
####.................#........................###................#.########..........####................##..............#######
####...............###.........................#.......##........#.#########..........####.###..........###...............######
###...............#####...............................####.........########............########.........#####............#######
###................###................................#####........#######..............#######........######.............######
##..................................................########.......#####.....................###.......####...............######
##..................................................##########.....###................................#####...............######
##..................................................##########.###.###.........##......................##.................######
##.................................S................##########.###.#..........###........#............####................######
##.......##..........................................#########.###.#..........#.........##...........####.................######
###....#####..........................................########.###.#.....................##.........#####................#######
##......###............................................#####.....#.#.....................##........#####.................#######
###....................................................#####.....#.##.....................#.......#####..................#######
##......................................................##.........##............................######..................#######
###....................................................###.......#.####..........................#####..................########
##.....................................................#.........#.####.......................##.######..................#######
####.................................................#.####....###.#####......................##....###.................########
#########............................................#############.######.....#..............###.....########...........########
############.#.##....................................#############.############..............##.......#########........#####.###
##################...................................#############.###########...............###.......########........###....##
#################...................................##############.############..............##.......###########....#.###....##
#####....########...................................##############...#########................#........#############.#.#.......#
#####......#####...................................#############.....##########........................#############.#.......###
###.........####...................................#####.#.#.#.###.....#######.........................#############.........###
###.........####.....................................#...........#....#########........................############........#####
##...........#####...........#.................................#####..########.........................#############......######
##.......#.#######...........#.......................#.......##################........#................############......######
#.......###########..........###.....................####.....################........###.................####.#####.......#####
##.....###########.....#......##.#...................######....################...........................###....###.......#####
#......########.#.....###.....####..................########.....######.#######............................##......#........####
##....#######.........###.....####...................#######....#####.....######..........................###......#........####
#......................##.....####..................#########...###.......######...........................###..............####
##....................###.....####...................############...........###...........................####...............###
#......................##.....####..................###########.............###............................####..............###
##....................###.....####...................########................#........###..................####........##......#
##.....................##......###...................#####...........................#####.................####........##.....##
###...................###......###.....................###...........................######..................###.......#.......#
###.............#......##.......##.....................##...........................########.................##...............##
####...........###.....##.#.................######.....####..........................###########.#............###..#..........##
####...........####.......##...............######......####.........................############.#.............#####..........##
#####..........####.......###........###########.......#####........................#####.#.####.#............######.#.......###
#####...........####.......###........########.........#####......................####........##.##............#####.#.......###
#####...........####.......####..........#.#............####....................######.......###.##...........######.#.##...####
#####...........####.......####.........................#####................#######.........###.####.#........#####.#.#########
####............#####......#####.........................###...............#########........####.######.......######.#.#########
###.............#####......#####........................######.............#######.........#####.#######.......#####.#.#########
###.............####.......######........................#######..........######.#.........#####.######.......######.#.#########
###............#####.......######.#.....................#######...........######...#.....#######.#####........######....########
####............##...........######......................######..........######...####.#.#######.####..........#####....########
#####..........................####......................######..........######...##############.###..........#####....#########
######.........................###......................#.#####.........#######...##############.####..........###.....#########
#######........................#.........................................######....#############.###..........###......#########
######.......................####...........................................#.....##############.####......#...###......########
######.....................#.####....................................#.............#############.###.......#.#####.......#######
#####..................##.########...................................###..........##############.####.....#########.........####
#####..................##.########....................................##..........##############.####......#########.........###
###.....####...........##.######.#.....................................#.........########.#.####.######...##########..........##
###.....######.........##.######..................................................#######....###.######...##########..........##
##.......#####..........#.#####...................................................######.......#.############......#..........##
###......######........##.#####....................................................######.....##.############.................##
##.......#######........#.#####....................................................#####......##.###########..................##
###......########.....###.######...........................................................#####.###########...........##.....##
###.....#################.#######........................................................#######.###########............###..###
####.....##.#############.########........................................................######.############...........########
####..........###########....#######.#.#................................................########.###########..............######
###...........#######.#......#######.###...................................#.#.........#########.##########..###..........######
###.............#####.........######.###...................................######....###########.#########.....#............####
#...............####..........######.###...................................########..###########.#.######...................####
#................####.......########.##.....................................#######..###########...#####.....................###
#................####.......########.###......................................####.....########......###....................####
#................######....#########.###......................................###......#######......####..................#.####
#...............########..##########.###.................................................######.....###.................########
##..............#########...########.###..................................................####.....####................#########
##............##########....########.###.........................................E.........#####..####...............#.#########
###...........###########.....######.####.................................###...............########..............##.#.#########
###..........############.....######.####.................................###...............#######..............###.#.#########
###..........#######..........######.####...................................................######..............####.#.....#####
###.........#######............###.....###..........................................#.......#####..............#####.#.....#####
###.........######............#####...#####........................................####.....####.............#######.#.....#####
###.........######.............####.#.#####.........................................#####...###..............#######.###.#.#####
####........#####......##.....##############........................................#####.####...............#######.###########
####.........###......###.#..################.........................###............######.###..............#######.###########
#####.................###.####################.......................#..............#####.....................######.......#####
####..................###.######################...................###..............###.......###............#######.......#####
##.#.................####.#####...##.#.#######....................##...........................###............######.........###
##...................####.#####...........####.................######.........................###.............########.......###
##..................#####.#####.#.........##.................#####.............................###............#########......###
##.................######.#########..............................................##............................#########......##
#..................######.#.#########..........................................####...................#.......#######.##.....###
##................######......#########.......................................####.....####........####........#####..........##
##.................####.......###########.....................................##......#####......######.......######.........###
##.#...............###.........############.........#........................###.......######....#####.........#####..........##
#####...............#.........########################.......................#..........#############.........#######.........##
#####..............##........########################...................#.####.............########..........########..........#
######......##.....#.........##########..##########...................#######................######.........###########........#
#######.....###..####.......##########.....####......................#####.#.................######.......##############.......#
#######...############.......#########................................###.........###.........#####......#################.....#
#######################.....##########...................#............####......######........#######...##################....##
########################.#.############.............#.#####...........####.....########.....#########.#.########################
########################################.........############........###################.#.#####################################
################################################################################################################################
