################################################################################################################################
########.#.#######.......######.#.########.########....#######.#.########.#.####.######.#.#.#.#....#.#.###.........#############
###........######...................####....####.......#####.S.....###......#.......#..............................########..###
##...........###.....................###.................##..........................................................######....#
##..........####......................##....................................................#........................#####.....#
##..........###........................#...................................................##..........................###.....#
##........#####........................##.................................................####.........................###.....#
##......#.####..........................#.................................................###....##............................#
##......#####...........................###...............................................###....#.............................#
##.......#................#..............######...........................................##....##.............................#
##......................###..............#######...............................................................................#
##......................####..............##.#.#...............................................................................#
##....................#####....................................................................................................#
###..................###......................................................................................................##
##..................####......................................................................................................##
##..................###....................................................##................................................###
#...................####..................................................####..............................................####
##...................###.................................................####............................#..................####
#....................####...........##.................................#####............................####...............#####
##.....................###..........###................................###..............................######.#............####
#......................###..........###..................................................................#########..........####
#.......................#.............##...........##...........................#.........................########...........###
#....##.......................#...................######.......................##...........................#####............###
#....##......................###.................#########.....................##..........................######.............##
#....###.....................##..................#########.....................##...........................####..............##
#...###......................#...................###..###..................................................###................##
###...........................................................................................................................##
###.....................................................................#........................#................##..........##
###....................................................................##......................###................###.........##
#..................##..................................................##.....................####................###.........##
#.................###.................................................###......................#...................##.........##
#................####.................................................##......................................................##
#................###.......................#...........................#......................................................##
#................####......................##.........................###....................................................###
#................###...................................................##...................................................####
##...............###...................................................#....................................................####
###........................................................................................................................#####
#####.........................................................................##............................................####
######......................#.................................................##............................................####
######..................#########.....................................##......##............................................####
#####.....................########..................................###.......#..............................................###
###.....................#########...................................###...........................#.........................####
##.......................####.....................................####............................###........................###
##.......................##......................................####.............................####.......................###
##...............................................................###...............................##.......##...............###
##............................................##.................#..................................#.......##.................#
####.##........................................#..............................................................................##
########.......................................................................................................................#
#######..................................................#.#..................................................................##
###.###.................................................#####.................................................................##
###....................................................#####....................................##...........................###
##.....................#...............................####....................................###..........................####
##....................###..............................##.......................................##..........................####
#.....................###......##.....................###................###...............................................#####
##....................###......##.......##.............................#####...............................................#####
#.............##......###......###.....#####.........................#...###................................................####
##............##......####.....###....######................##.....###...###..............................#..................###
##..........###........####.....####.#######.....###.......#####....#...................................#####.................##
##.....................#####.....##########....####........####....#...................................#####...................#
#...........#####.......####......####.#.......####........####........................................####....................#
##...........####........####....###............##......................................................###....................#
#............###..........##......##...........................................................................................#
##..........###...........###....##............................................................................................#
##....###.........................#.............................................###..........................##...............##
#....####....................................................................######..........................#................##
##....#....................................................................########..........##..............................###
#................................................#.#.#.....................######...........###...............................##
##.....................................####....########.....................#####............#.................##.#...........##
##.....................................##############..........................................................######..........#
##.....................................###########............................................................#######..........#
##......................................########...............................................................######..........#
##......................................#####...................................................................#####..........#
##.......................................##.......................................................................##...........#
##.......................................###.....................................................................###...........#
##........................................#......................................................................#.............#
##............................................................................................................#####............#
###........................................................................................................#######.............#
##.........................................................................................................######..............#
###..........................................................................................................#.................#
###......................#.....................................................................................................#
###.....................###....................................................................................................#
##.......................#.....................................................................................................#
##............................................##...............................................................................#
##.........................................#.###..............................................................................##
##.......................................#######..............................................................................##
##.......................................#.####....................#..........................................................##
##.................................................................##.........................................................##
##...............................................................######........................................................#
##...............................................................######.......................................................##
##...............................................................######........................................................#
##.................................................................##...........................................###...........##
##.................................................................###..........................................#####.........##
###...................#..............................................#.........................................######.........##
###...................###....................................................#.................................#######.........#
###...................###....................................................#...............................########..........#
##....................########...............................................##...............................#######..........#
##....................#######.........................#........................................................####............#
##.................#####.............................###...............................................###.......#.............#
##.................#####.............................##....#...........................................###...............#.....#
##.................###..................................................................................###..............###...#
##..........................................##...........................................................................#######
##.........................................###...............................#.............................................#####
##.........................................####...........................................................................######
##........#................##.............####.............................................................................#####
##.......###...............###............####..............................................................................####
##........##..............######.........####.................................................................................##
###........................#######.......####.......................................##.........................................#
###.......................########......###...............#...........................#........................................#
##.........................########.....##...............##.........................#####......................................#
##........................########.....##........##.....##...........................######................#...................#
##........................########................#.....###..........................#######...............##..................#
##...........................####.......................###...........................#####.......#.........#..................#
###...........................###..........#...........####...........................######......#.........#..................#
##............#..............####..........###.........####...........................#####.....#.#............................#
##..........####.............#####..........##.........###..............................###...###.#.............#..............#
##...........###............######............................................................#####.............##.............#
#............##.............##...#..............................................................###............###.............#
##.............................................................................................................##..............#
#.............................................................................................................###..............#
##...........................................................................................................###...............#
#.................#......................................................................###.................###...............#
##................##.........................#...........................................#.#.#...............##...............##
#...........#....##........###..............###.......E......................................##.........................#.#.####
##....#....#......##.......####.............###.......................................................................##########
#....###.#####...##.......#####...........#####.......###................###.###.............#........................##########
###.##########.######...#######...........######.....####.......#.......##########.#.#.......#.#....................############
#################################.#.#.#.##########.#.#######.######....############################.#.#.............############
################################################################################################################################
