################################################################################################################################
##########...............########################################################.##############################.###############
##########................#####..#######.........#.#.#######....################....############################....#.#.#.#.####
##########..................#.....######..............######......#####......#......###########.....###########..............###
##########.........................###.................####.........#...............########..........##.#.######.#.........####
###.#..#...........................###..................####........................#######................#########........####
#................#................###....................###.........................#######................########.......#####
#...............###..........########.....................##..........................######...............#######.#......######
#...............####.........########...........##.........###..........................######.............######.........######
##..............####..........#######..........###.........###.............###.............###...........#######.........#######
##...............####............####..........####.........###...........###..............####..........######.........########
####...............................##.........#####..........##...........#..................#..........######.........#########
####...............................##...........###.......................#..................#...........####.........##########
#####...........................................###...........................................#..........###.........######.####
#####............................................##.....................#....................##......................#####...###
####........................................##.####....................#..........##.........##.....................#####...####
####.......................................########...................###.........##................................####....####
###........................................########...................###........##.....................###........####....#####
###.........................................######.....###...........###...........................................###.....#####
###.......................#.#.#.#.............####.....#####.#.......####..............#..........................####.....#####
###......................#########......................######.......###..............##...........................###......####
###.......S.............############...................#######.......####...........######.........................###......####
####.....................##########.....................####.........####...........########.........................#.......###
####.....................###########....................##...........#####.........#########.........................#........##
######........................####....................................####.........###.#.#....................................##
########................................#.......#.....................#.#..........#.........................................###
##########.............................##.......##.................................#........................##..............####
##########............................####......##................##......................................####.............#####
#######.##........................................##...###........##......................................#####.............####
######...........................................###.######..............................................#####.............#####
#####.........##..................................#########.......................##.#...................#####..............####
###............##................................###########.....................#######..................###..............#####
###...........###................................##########......................#########.........##.......................####
#........#..####.##.............................###########......................#########.......#######....................####
#........#.#.....................................#####...........................#########.......#######.....................###
#........#......................................######...........................#######.......#########...............##....###
#...............................................#####............................########.....######...................####.####
#...............................................#####............................#######.....#####....................##########
#.................................................####..........................###...###....######....................#########
#.................................................###..........................####....##...######.....................#########
#..................................................###........................###.......###.######.......................#.#####
#.....#............................................##.......###..............####.......#########..........................#####
#....##.....................................##...............###.............###........#########...........................####
#....###...................................####.............................###.........#######............................#####
#....###..................................######............................###.........######...............#.............#####
#....###.....................#.#..........#######...........................##........########..............#####..........#####
#.....##....................###...........########..........................##........######...............########.........####
#.....###.................######..........########...................................#######................#######...........##
#......###...............######............#####..................#.....................####...............#########...........#
#.......#................######.............####..................##.....................###..............####...###...........#
##.........................###..............###....................#......................##........#.....####....###..........#
#..........................##................##....................##.....#...............##........##....###.....##...........#
##......................................................................####..............##........##....###......#...........#
##......................................................................#####.............##........##.....#...................#
##.......#.#............................#..............................######..................................................#
####...###.###.........................####............................#######................................................##
###..#####.####.......................######...........................#######..........................#.....................##
###...####.####.......................#######...........................######..........................##...................###
##...........##........................######.........##..................###............................#...................###
##.....................................#####..........##......................................................................##
#.......................................##............#......................................................................###
#.........................##.#................................................................................................##
#.........................#####...............#####..........................................................................###
#............###..........######.............#######..............#....................................####...................##
#............###...........#####............########.............##.................#.................#######................###
#.....###..#####...........####............##########...........##................#####......................#................##
#....#####.#####...........####............##########..........###..........#....######.......................................##
#....#####.####............###.............######.#...........###..........####.#.######.......................................#
#.....####.###.............##..............###..............#####..........####.#...####......................................##
##....##...................###..............##.............#####............#####.....#........................................#
#......##..................###.............................#####...........#####...............................................#
##......#..................#####..........................#####.............######.............................................#
#......##...................#####..........................###.............#######................###.........................##
##......#...................#####..........................##...............########........##.....##......................#####
##.....#.....................#.#...........................................#########.......####...###......................#####
##.........................................................................#########........#####...#......................#####
##....##..................................................................#####..###.........####...........................####
##....##..................................................................#####...#...........###........#.###................##
##..###....................................##............................#####..........................#####.....########.....#
########.................................#####...........................######........................####......##########....#
#...####................................######............................####.........................####.....##########.....#
#...####................................#####............................######.......##..............###.......#########......#
#....###................................#####.............................####........#...............###.......###.#.#........#
#.....###.................................#..............................#####........#...............###.......#.............##
#.......#.....................#.#.........................................###................##......####......##.............##
#...........................#####........................................####...............####......#####..###............####
##........................#######........................................###......###.......#####.....#.#######.............####
##.........................#####.........................................####....####......##########...#######...........######
###....................#########.........................................###.....######....############.######.........#########
####.............#.######..###...........................................#####.########...###################.........##########
####.............#########.................................................##############.###################........###########
####............#########....................................................###################.##########...........###.######
###.............#####.####...........................................###........############.......#......................######
###............####.....#............................................##...........#######..................................#####
###.............###..................................#...............##..........####.#.#.................................######
##............####.............................##.#####..............##...........###.....................................######
##........########.............................#######...............#......###.###............................#..........######
##......###########.............................#####.........................#.###...........................####........######
#.......##############........................................................................................####.........#####
##.....################...................##....................................................................#...........####
#......###############....................##...............................................................................#####
##....##############..............................................................................##........................####
#.....#######....................................................................................#####......................####
###.#########....................................................................................#####.......................###
###########...................................................###...............................########....................####
###########.............................#.....................###...............................#########.............##.....###
###.#.#.#..............................####..................####...............#..............###########............#......###
###....................................#.##...................####............####.........#...#.#########...................###
#..............##............................................########........#####.........#.#.#........#.....................##
##............####...............................##..........########.........###..........#####..............................##
#.............####...............................##..........#########.......####...........###................................#
##............###................................###..........#######........###.............##................................#
##.............#..................................................####.......##.......................................###......#
###.........................................#.....................####...............##..............................####......#
###.......................................#####............###.....####.............#####............................######...##
####.....................................#######......########....####..............#####...........................###.#...####
###........................##..........########......#########...#####.............######.........#.................###...######
####.......................####....#.#.#########......####.#.....#####.............######.......####E..............###......####
###.........................####.###############.....####........#####.............####.........##.................###......####
####.......#..................############..####......##...........###.............####.......####................####.......###
####.......#...................##########...###.......##...........###.............####......###...................###........##
####.....#######.................#########............##...........####............####.......#...................####.........#
#####....##########.#............#########.#..........####.#......#####............######..........................##..........#
######################.............#########..........###################.........#######.........................###.........##
#######################............##########........####################........##########.#.....................##.........###
########################...........##########......#.######################.....###############..................####.......####
#########################......#.##########################################.#.####################.#..........#######.#.#.######
################################################################################################################################
