################################################################################################################################
###########.............................................................................................................########
##########...............#####...############....###############.###..###..#########....#####.......########............##...###
##########.................##....############....###########..##.##.........########.....###.........#######..................##
##########.......................############....##########......##.........#######......###..........#######.................##
#####.....##......................############...#########.......###.......####..........###...........#######................##
####......##......................############...####............###.......###............##...###.......######.....##........##
####.............................####...#####....###.............###.......##.............##...####........####....####.###..###
###....................##........###.....####.....#..............##............................#####........####...####.########
###...................####.......###......###..................#.##.............................####........#####.#####.########
###...................####.................#............########.#...............................##.........###########.########
###...................####.............................#########.........................................##############.########
##.......###..........####............................##########...................##...................###############.########
##.......####.........####............................#####................#......####..................#############...########
##.........#..........###...............##..#####......###................###.....#####..................##########.....########
##................................##...###########................................####....##..............########......########
##....#..........................#################................................####....###..............#####........###...##
###..###.........................#################..........##...###.............#####....###...............###.........###...##
###...#............###...........############..##..........#####.####...........######.....#............................##....##
###...............#####..........#####..####...............#####.####...........#####...................###...................##
####...........########.........#####....##................###...####............###...................#####..................##
####..........##########.....########....##...............###....#####.................................######.................##
####.........###########....#########...####.............####....######................................######.................##
###...........#..#######....###...##....#####..........######.....######.................................###.................###
###................#####....##..........#####.......S..#######.....######............##..........###......##.................###
###.................###..................###...........#######......########.....#######....#########........................###
####................###.........................###....#######......#########....#######...###########..............##.......###
####................###........................#####...######........###..####...########...##########.............####......###
####................####.............#####......#####..#####..............####.......####........####..............####.....####
###........##........####............########.....##########..............#####...................................#####.########
###.......###..........###...........#########......########............#######............#......................#####.########
##.......####...........####..........#########..........####...........#######...........###...........##........#####.########
#.......######...........###...........########...........###...........#######...........######.......####........####.########
#.......######............##...........########............#.............######............######......#####........###.########
##......######.........................########...........................####..............######.....######.......###.####.###
###.....######..........................#######...........................####..............########....########....###.###...##
#####...#######.........##.......#........####............................####..............#########.....#######...###.##....##
######..########........###.....####.............................##......######............##########......######...###.#.....##
######...#######........###......####............................###.....#########........############.....#####.....##......###
#####....########..................###...........................##......##########......###############....##...............###
#####....#########..................###..................................#########.......################....................###
#####........########................###................................######............#####....#######...................###
#####.........##########..............#####...........................#######...............##......#######..................###
####..........#####..#####..............####.........................########........................######...................##
####..........####....#######............###........................#########........................######...................##
###...................########......................................#########..........###...###.....######...................##
###....................########......................................#######...........##########....#######.................###
####......................#####.....................#####............######...............#######....#######.........##......###
########...................#####....................######..........#####..................#####......#####.........###......###
#########..................#####....................#####...........####............................................###.......##
##########.................#####.....................###...........#####........###..................................##.......##
#############..............####...................................#######.......###..................................##.......##
##############..............##................................##.#########..........................................###......###
#########...#...............##..................##...........###.############.......................................###......###
########.......................................####..........###.#############......................................###......###
#######...............###.........#............####..........###.......#######..............................#........##......###
####.................####........###...........#####........###..........####...............................#...............####
###..................####........###...........######..##..####.....###..###...............##...............##.............#####
##....................##........###...........#################....#########...............###.....###......###...........######
##.............................####..........###......###..#####..###########..............####....####......#............######
##............................#####.........###.............#################................###....###....................#####
#...........................................###..............#######..........................###....##....................#####
#..............................###.........###...............#######..........................###..........................#####
#.........................................####......####....########...........................#...........................#####
#.........................................####.....######...#########......................................................#####
##........................................###......######...##########..................##.......................##.......######
###...###.........................................#######..############.................###...........##........####.....#######
#########............................###.........################....#####..............#######......####........####....#######
#########............................####.......################.......####............#########.....####.........###....#######
########.............................##########################.........##............##########......####.........##....#######
#######................................#######################........................#########.......####.........##.....######
###............................#........##############...####.........................#########........##.........###......#####
##............................###.......#############.................................#########..................###........####
##.............................###.....##############.................................##########..............#####..........###
##..............................##....##############..................................###########..........########..........###
##....................................##############...................................###########........##########........####
###...................................###############........................................#####.......############......#####
###.........###........###............###############.........................................###.......#############......#####
###.........###.......#####............#############...##.....................................###.......#############......#####
##..........####.....#######............###########...####...................................###........############.......#####
##..........################.............#####.###...#####.........######.........#.........###.........###########........#####
###.........###########...................###.......#####..........#######.......###........###.........#####...##.......#######
#####......###########...................#####......####...........########......####........###.........###............########
######....#####..####...................######......####...........###..####.....####........####.......................########
######....####....###................##########......#######......###....####.....###........####.......................########
#####......##.....###................###########.....########.....###....#####....###.........##.............##..............###
####...............###...............###########......#######.....##......####....####................#########..............###
###....####........####......................##.......#######..............##....######.............###########...............##
##....######.......####..............................########...................########...###.....############...............##
##....########......###.............................##########.................################....############....###.......###
##....#########...................................#############.....##.....###################......###########....###....######
##....########...................................#######...#####...#########.##############.........######...##.....##...#######
##.....######.......................###..........######......####...########.#############...........####....##..........#######
#......#####.......................#####.........######.......####.....#####.#############..................##...........#######
#......####........................######.........#####........###......####.##############................##.............##...#
#..................................######.........#####.................####.###############..............###.............##...#
#.................#####............#####.........#######................####################.............####............###..##
#.............#########............####.........#########...............################..#.............####.............###..##
#............##########...........####..........#########...............###############.................####.............##...##
##..........##########............####...........#######.................####.#########................#####..................##
##..........##########.............##................##...................##...#########............########..................##
##...........#########.............................................##..........##########...........#########................###
##.............######.............................................####.........##########...........##########..............####
###..............................................................#####.........#########.............#########..............####
####...............................##..........###...............######.........#######...............########..............####
####..............................####........#####................#####........#######........##......#######.............#####
####..............................####.........####.................####.......#########..########........................######
###................................##..........####..................####......####..#############......................########
##.................#####.......................#####..................##........#.....######...##.......................########
##................######.......................#####..................................#####...........................#.########
##...###..........####..........................####...................................###............................#.########
##..#####..........##............................##.................##......###.......####...........####............##.########
##..#####...........................................####........#######....##############...........#####.......##..###.########
##..#####................................###.......######.......#######....#############.............####......########.########
##..####.........####...................####.......#####........#######.....###########........................########.########
##...##......#########..................####......####..............##........##................................#######.########
##..........#########....................###.....####.............................................................#####......###
#...........#####.........................###....####......#.........................................#####.........###........##
#............###..................................##......##....................##...................######.......####........##
#............###.........................####..............#....................##...................######......#####........##
##...........####.......................#####..............................................###......######.......######.#....###
###......##..###########................#####...........................................#######....#######........########...###
###.....##....###########...............######.........................................########....########.......########...###
##.....###.....##########....##..........######.........#####...............##.........#######...##########.......########..####
##.....##........#########..#####.........######.......#######.............####E......########..############.....###############
##....####..###..##################.......#########...########.......###..######..##############################################
###..##################################..######################.....############################################################
################################################################################################################################
