################################################################################################################################
################################################################################################################################
######.#########################################################################################################################
######.#########################################################################################################################
######.#########################################################################################################################
######.################################################################################################################........#
######.#########################################################################################################################
######.#########################################################################################################################
######.#########################################################################################################################
######.#########################################################################################################################
######.#########################################################################################################################
######.#########################################################################################################################
######.#########################################################################################################################
######.#########################################################################################################################
######.#########################################################################################################################
###################################################################..................###########################################
############.................######################################..................###########################################
###############.###################################################..................###########################################
###########.........###############################################..................###########################################
#########.............#############################################..................###########################################
########...............############################################..................###########################################
#######.............E...###########################################..................###########################################
######...................##########################################..................###########################################
######...................##########################################..................###########################################
#####.....................#########################################..................###########################################
#####.....................#########################################..................###########################################
#####.....................#########################################..................###########################################
#####.....................#########################################..................###########################################
####.......................########################################..................###########################################
#####.....................######################################################################################################
#####........S................##################################################################################################
#####...........................################################################################################################
#####............................###############################################################################################
######............................##############################################################################################
######............................##############################################################################################
#######............................#############################################################################################
########...........................#############################################################################################
########...........................#############################################################################################
########...........................#############################################################################################
###############.....................############################################################################################
################...................#############################################################################################
################...................#############################################################################################
################...................#############################################################################################
################...................#############################################################################################
#################.................##############################################################################################
#################.................##############################################################################################
##################...............###############################################################################################
###################.............################################################################################################
#####################.........##################################################################################################
#########################.######################################################################################################
################################################################################################################################
################################################################################################################################
################################################################################################################################
################################################################################################################################
################################################################################################################################
################################################################################################################################
################################################################################################################################
################################################################################################################################
################################################################################################################################
################################################################################################################################
################################################################################################################################
################################################################################################################################
################################################################################################################################
################################################################################################################################
################################################################################################################################
################################################################################################################################
################################################################################################################################
################################################################################################################################
################################################################################################################################
################################################################################################################################
################################################################################################################################
################################################################################################################################
################################################################################################################################
################################################################################################################################
#####################################################################################.....######################################
#####################################################################################.....######################################
#####################################################################################.....######################################
#####################################################################################.....######################################
#####################################################################################.....######################################
#####################################################################################.....######################################
#####################################################################################.....######################################
#####################################################################################.....######################################
#####################################################################################.....######################################
#####################################################################################.....######################################
#####################################################################################.....######################################
#####################################################################################.....######################################
#####################################################################################.....######################################
#####################################################################################.....######################################
#####################################################################################.....######################################
#####################################################################################.....######################################
#####################################################################################.....######################################
#####################################################################################.....######################################
#####################################################################################.....######################################
#####################################################################################.....######################################
################################################################################################################################
################################################################################################################################
################################################################################################################################
################################################################################################################################
################################################################################################################################
################################################################################################################################
################################################################################################################################
################################################################################################################################
################################################################################################################################
################################################################################################################################
################################################################################################################################
################################################################################################################################
################################################################################################################################
################################################################################################################################
################################################################################################################################
################################################################################################################################
################################################################################################################################
################################################################################################################################
################################################################################################################################
################################################################################################################################
################################################################################################################################
################################################################################################################################
################################################################################################################################
################################################################################################################################
################################################################################################################################
################################################################################################################################
################################################################################################################################
################################################################################################################################
################################################################################################################################
################################################################################################################################
################################################################################################################################
################################################################################################################################
################################################################################################################################
################################################################################################################################
