################################################################################################################################
##############################################.#.#......###########################.#.#.###################.....########.#######
######.#.#.##############..........###########............####............######........#############.#.#.........####...#######
#####........##########..............#######.............#####............#####..........####.#.####..............###......#####
####..........#######..................#####.............####..............####.........#####.....................####.....#####
###..........######....................####..............#####............#####........####........................###......####
##...........####......................#####..............####.............####......######........................####.......##
##..........######.....................#####.#............#####............####......#####...........................##.......##
##..........#####......................#########...........####............####......######...................................##
##.........#######......................########...........####............###.........###.......#####........................##
###........#######......................########..........#####............###.........####....########........................#
###.......##.#.#####.###..................#####.........######.............###...........###..#########........................#
####...........#########.....##...........#####.........######.............###.............###########.........#...............#
####.............########...##.............###..........####...............##.............########.#..........##...............#
###...............######.....#.........#.#####...........###...............................#####.............####..............#
###.................###..............#######.............#................................######.............###......##.......#
###.................................########..............#...............................#####..............####.....###......#
##...................................#####........####...................................#####..............#####...####.......#
##...................................#####........####....##.............................####................######.######....##
#....................................###.........######....###.#.##......................###................####################
#....................##...............##.........#####......#######......................###................####################
#......##...........#####.....#......##..........######.......###........................###..............#######....###########
##....####...........#####..####.................#.####..................................###.............#######.......#########
##.....###...........############..................####..................................####............######........#########
###....####...........###########.................###.....................................###..............###...........#######
###......#.............##########..........#..............................................##..............................######
###.....................#########........####...............................................................................####
##.....................############......####.................................................................................##
###....................#############.....###..................................................................................##
###..................###############..........................................................................................##
#####...............###############...........................................................................................##
#######.............##############.....................#...................................................#..................##
#########...........#######.#.####.....................###.................................................###...............###
#####.#.#...........#####......##......................#######...............................................###.............###
###..................#####..............................#######..........#...................................####............###
###.................#####................................######..........###...................................###............##
##.................#######................................#####..........####..................................####............#
###................#######.................................#####..........###...................................####...........#
##................########.................#..............................###...................................######.........#
####.............####.....................#####.#.........................##.....................................#####.........#
###..............###......................#######.................................................................#######......#
####............####......................#######.................................................................########.....#
##..............###...........##............#####.......................................#.........................#########....#
##..............###.#........###............####........................................##........................########....##
#...............#####........###............####.....##.............##.................####...................................##
##.........##...######........#............#####....######.........##..................###....................................##
#........###....#######.......#............#####.....######........###......###........###....................................##
##.......#.......#####....................######.......###.......####......######......##..........##.........................##
##...............#####....................#####................#.#####....#######......###..........#.........................##
####...............##....................#######..............########.S.#####.........##.....................................##
######...................................######..............################.........####....................................##
#######..................................#######.............###############..........###.....................................##
##..##...................................######..............##############............###....................................##
#...###...................................######..............############.............####...................................##
#....#....................................######.............####.#.#.###...............###...................................##
#..........................................#####..............###........................###....##............................##
#..........................................#####..............#.................................##............................##
#...........................................#####.............................................................................##
##............................#...............#..........####.................................................................##
##...........................###..............###.......###........................#.........................................###
###..................................#.................#####.....................#.##................................##.....####
###..................................##...........#.#.#####......................#.##..............................####.....####
###...................................##...........########.......................###.............................#####....#####
###..................................###..........########........................###..............................####.....####
#.....................................##..........#######..........................##..............................####......###
##...................................##...........######..........................##................................###........#
#................................................########..........................#..........................##...............#
##...............................................########....................................................##................#
##..............................................#########......................................................................#
####.##..........................................#######...................#..................................................##
########........................................#####.....................###.................................................##
########.........................................###.......................#................................................####
#########......#................................###...................................................................#.....####
#########.....####..............................###.................................................................###.....####
###....#.......#####...........................###.............................................................#....####....####
##.............######..........................####...........................................................##...####......###
#...............######........................####.........................................##................###....####.....###
##.............#######.........................###...............##........................###......................###.......##
#...............#####...................#.......#..............#####.......................###.....................#####.......#
##.............######...................##...............#.....#####.......................##....................#######.......#
#..............####.....................#..............#####...####.............................................########.......#
##...........######....................................######...###.............................................########.......#
##...........####......................................#####...###.......................................##.....########.....###
##..........######.....................................######..###.........................................#....#########.#.####
###........######............................###.......##########................................................##########.####
##.........####............................#####.......##########................................................##########.####
###........####...........................#####........#########.....................................#............#########.####
##..........##..............####.........#######........########....................................###.............#######.####
##.........###............########.........#.#..........######.....................................####..............###########
#...........##...........#########........................##......................................#####..............###########
##.........###...........#########...............................................................#####...............###########
#...........##.....#......####.#...............................................................E.#####...............###########
##.........##.....###...........................................................#.#.............######..............############
#..........##......#.........................................................#######............#####...............###..#######
##.........#..........................................###....................######............#######..............#......#####
##....................................................###..................######...............#####........................###
####.................................................####.................####..................#####........................###
####.................................................###.................#####....................#........###................##
######.................####..........................###.................####..............................####................#
#######................#####........##...............###................####................................####...............#
#######.........#......######.......##...............###................####.................................#########.........#
#####..........####.....####.........................###...............####...................................##########.......#
##.............#####....#####.........................##................###..............##....................###########.....#
##..............#.####.#####..........................##...............###..............####....................##########.....#
#......................######...........................................##.............#####.....................###########..##
##...................########...........................................###...........#####......................###############
#...........#.........########..............##...........................##...........####.........................#############
##.........###.........#######..............###..........................####........####...........................############
##........####........#######....................................###......###........###.............................###########
###.......####........................#..........................####.....#####.......###.............................######.###
###.......####......................###.........................#####.......#####....................................#####.....#
####......###......................####.........................####.........####.......##............................####.....#
####......###......................###.........................#####..........####.......#......###..................####......#
#####......##......................##............##............###.............##........##....######.................####.....#
#####..........................................#####.........#####.......................##.....######.................##......#
#####..........................................####..........###................................#######.......................##
######..........................................#..........#####.................................#####........................##
######.....................................................#.###..................................#.#........................###
######.......................................................###..............................................................##
######....................................#...................##.............................................................###
#####......................#.##.........####..................####.###............................................#...........##
######...................#######........####.........##......###########.................................##.......#..........###
#####..................##########.......#####........###....############................................#####....####........###
######................###########.......#####........###...##############........####..............###..######...#####.....#####
######...............###########...#....#####.......#####################...##.#####...............##...########################
#######.............##################.#######.....#######################..##########..####.....###############################
########.#.#.##################################.#.########################.###################.#.###############################
################################################################################################################################
