################################################################################################################################
################################################################################################################################
##############################################################################################..........########################
################################################################################################################################
################################################################################################################################
################################################################################################################################
################################################################################################################################
################################################################################################################################
################################################################################################################################
################################################################################################################################
################################################################################################################################
################################################################################################################################
################################################################################################################################
#########################################.######################################################################################
#########################################.######################################################################################
#########################################.######################################################################################
#########################################.######################################################################################
#########################################.######################################################################################
#########################################.######################################################################################
#########################################.######################################################################################
#########################################.######################################################################################
#########################################.######################################################################################
#########################################.######################################################################################
################################################################################################################################
################################################################################################################################
################################################################################################################################
################################################################################################################################
################################################################################################################################
################################################################################################################################
################################################################################################################################
################################################################################################################################
################################################################################################################################
################################################################################################################################
################################################################################################################################
#########################################......#################################################################################
#########################################......#################################################################################
#########################################......#################################################################################
#########################################......#################################################################################
#########################################......#################################################################################
#########################################......#################.###############################################################
###############################################.............####.###############################################################
################################################################.###############################################################
################################################################.###############################################################
################################################################.###############################################################
##########################################################.............#########################################################
########################################################.................#######################################################
######################################################.....................#####################################################
####################################################.........................###################################################
###################################################...........................##################################################
##################################################.............................#################################################
#################################################...............................################################################
################################################.................................###############################################
###############################################...................................##############################################
###############################################....E..............................##############################################
##############################################.....................................#############################################
##############################################.....................................#############################################
#############################################.......................................############################################
#############################################.......................................############################################
############################################.........................................###########################################
############################################.........................................###########################################
############################################.........................................##.....####################################
############################################.........................................##.....####################################
############################################.........................................##.....####################################
############################################.........................................##.....####################################
#######################################.....................................................####################################
############################################.........................................###########################################
############################################.........................................###########################################
############################################.........................................###########################################
############################################.........................................###########################################
############################################.........................................###########################################
############################################.........................................###########################################
#############################################.......................................############################################
#############################################.......................................############################################
##############################################.....................................#############################################
##############################################.....................................#############################################
###############################################...................................##############################################
###############################################...................................##############################################
################################################.................................###############################################
#################################################...............................################################################
##################################################.............................#################################################
###################################################...........................##################################################
####################################################.........................###################################################
#####################################################......................#####################################################
#####################################################....................#######################################################
#####################################################..................#########################################################
#####################################################.............##############################################################
#####################################################.............##############################################################
#####################################################.............##############################################################
#####################################################.............##############################################################
#####################################################S............##############################################################
#####################################################.............##############################################################
#####################################################.............##############################################################
#####################################################.............##############################################################
################################################################################################################################
################################################################################################################################
################################################################################################################################
################################################################################################################################
################################################################################################################################
################################################################################################################################
################################################################################################################################
################################################################################################################################
################################################################################################################################
################################################################################################################################
################################################################################################################################
################################################################################################################################
################################################################################################################################
################################################################################################################################
################################################################################################################################
################################################################################################################################
################################################################################################################################
################################################################################################################################
################################################################################################################################
################################################################################################################################
################################################################################################################################
################################################################################################################################
################################################################################################################################
################################################################################################################################
################################################################################################################################
################################################################################################################################
################################################################################################################################
################################################################################################################################
################################################################################################################################
################################################################################################################################
################################################################################################################################
################################################################################################################################
################################################################################################################################
################################################################################################################################
################################################################################################################################
