################################################################################################################################
####....####.#.#.#.#....#.#########.#.##.#.#.#.######.#.#.................######..................###############.#........#####
##..........................#####...........................................##......................###########..............###
##..........................####......................................................................########...............###
##......................................................................................................#.##..................##
#..............................................................#..............................................................##
###...........................................................###..............................##.............................##
####..........................................................###..........................#.####.............................##
#####........##...............................................###.........................###.#...............................##
####.........##................................................#.........................####.................................##
####........###..........................................................................###..................................##
###.......................................................................................##..................................##
###.......................................................................................##..................................##
###.......................................................................................##..................................##
###........................................................................................#..................................##
####......................................................................................##..........................#.......##
###.......................................................................................#.......................##.##.......##
###....................................................#........................................................###...........##
##........S..........................................#####......................................................###...........##
###..................................................######.....................................................#............###
##....................................................#####..................................................................###
###...............####..................................#....................................................................###
##................###.........................................................................................................##
##............................................................................................................................##
#.............................................................................................................................##
#..............................................................................#..............................................##
#..............................................................................###.................................##.........##
##..............................................................................####.............###................###.......##
###...............................................................##..............##...........####.................####......##
####..........................##.................................####.........................##......................##.......#
#####........................####.................................###.........................##......................##.......#
####..........................#####..............................####........................#........................##.......#
#####..........................########...........................##...........................................................#
#####..........................######.............................###..........................................................#
#####............................####..........................................................................................#
#####..............................#...........................................................................................#
#####..........................................................................................................................#
######.........................................................................................................................#
#####..........................................................................................................................#
######.........................#...............................................................................................#
#######..##....................###.............................................................................................#
############...................####............................................................................................#
####.######......................##..................##..............####......................................................#
##....####...........................................###...............##......................................................#
##......#.............................................#........................................................................#
#..............................................................................................................................#
##.............................................................................................................................#
#...................................###.......................................................................................##
##.................................#####.......................................................................................#
##...........................##....####........................................................................................#
##.........................######...####...................##..................................................................#
##.........................######...#......................#...................................................................#
#..........................######..........................##..................................................................#
##............................#............................##..................................................................#
#...................................................................................###.........................####...........#
#...................................................................................###..........................###..........##
#.............................#.................................................................................#####........###
#.............................#..................................................................................####.......####
##...........................##.................................................................................####........####
#................................................................................................................###........####
#....................................................###.........................................................#..........####
#...................................................#####...................................................................####
#..................................................#######...................................................................###
#.................................................#########..................................................................###
#.................................................########...................................................................###
##...........................................................................................................................###
##...........................................................................................................................###
###..........................................................................................................................###
###..........................................................................................................................###
###.....##...................................................................................................................###
###.....##...................................................................................................................###
##.....#####.................................................................................................................###
###...########...............................................................................................................###
###..########................................................................................................................###
#############...................................................##............................................................##
############....................................................####.........................................................###
######.#.##......................................................#####........................................................##
######...###......................................................####........................................................##
#####.....#.......................................................#####.......................................................##
#####.....##.......................................................####......................................................###
####................................................................####.....................................................###
###...................................................................##....................................................####
##...........................................................................................................................###
#..............................................................................................###...........................###
#................................................................................##.............##............................##
#...............................................................................##............................................##
#...............................................................................##.............................................#
#.................................#.#..........................................###.............................................#
#...............................######..........................................#..............................................#
##..............................######.........................................................................................#
##...............................#####.........................................................................................#
##.................................##..........................................................................................#
#.....................................................................#......................................................###
##...................................................................###.....................................................###
#......##........................................##...................###...................................................####
##....###........................................########.............##.....................................................###
#......#.........................................#########...................................................................###
##..................................................#.#.#................................#.....................................#
##......................................................................................##....................................##
###......................................................................................#.....................................#
###.....................................................................................###...................................##
###......................................................................................##....................................#
####................................#.........................................##.........###..................................##
###.................................##.......................................####.........####................................##
####.........................................................................####..........#####.............................###
###..........................................................................######..........####.............................##
####.........................................................................######............##............................###
###..........................................................................#########........####............................##
###..........................................................................##########.......###.............................##
#.............................................................................#######.#.....####..............................##
##............................................................................#####.........##................................##
#..............................................................................####E...........................................#
##............................................................................................................................##
#....................#.........................................................................................................#
##..................###.......................................................................................................##
#....................#..............................................##.........................................................#
#...................................................................#.........................................................##
##........................................###..................................................................................#
#.........................................###.................................................................................##
##.............................................................................................................................#
##............................................................................................................................##
##.............................................................................................................................#
###........................................................#..................................................................##
###.......................................................###.................................................................##
####.....................................................###....................#.##.........#................................##
#####...................................................#####................#########.....#####......#...........####........##
######.#.####.................................####.....######.#.#.#.#.#.#.############....#########.#####.......########.....###
################################################################################################################################
