################################################################################################################################
##.......................########################################....###.....##################################....###..########
##.#########.....#####.......#########......#############..####.................###.........#################................###
##.########.......###.........#######........##########.....##...............................#####..########.................###
##.#########......###............####.........########......##...............................####....######.......#..........###
##.###########....###.....#.......####........########.....###........##.....................###.....######......###.....#######
##.############..####....###.......####.......###...###....###.......####.....................##......#####.....####....########
##.####..############....###........###........#.....###...###......####.......#..............###......####....####.....########
##.###.....##########....####.......###..............###...####......#........###.............###.......##....####......########
##.##.......#########.....####.....####...............#.....#####............####.............####............###.......########
##...........########......###......##.......................####..........#####.............#####...........###.........#######
##...........########....................................................######..............####............###...........#####
##...........########...................................##...............###.................###............####............####
##............#######..................................####..............##...............................######...........#####
##.............#####...................................####......................##......................########......#########
##..............####....................................###...................######.....#...............#######......##########
##..............####....................................####.................#######....###..............#####........##########
#...............####....................###.............####........##.......########....###............#####.........##########
#...............#####................######............######.....#####............###....#............#####.............#######
#.................###....##.........#######........#...######....######............####.............########.................###
#.......................####........#######.......###...####.....######............####............#########....##............##
#.......................#####........#####........###....###.....#####.............####............#########...#######........##
##......................#####............................###.....#####............######............########...########.......##
##.....................#####.............................####.....#####..###############.............######....########.......##
##........S............####....................#.........#####......#####################......................#######........##
##.....................####...................###.........#####........##################......................######.........##
##......................####...................#..........######..........##############.......................######........###
##.......................####.............................######...........############.........................#####........###
##.......................####.............................#####.....#......############..........................#####.......###
##...............##.......###.............................####.....###.....#######..###............................###.......###
##..............####.......##..............................###......#......######....###............................##.......###
##.#............####.......##..............................####...........######.....####...................................####
##.##............##.......###.......................###....#####.........######......####...........###....................#####
##.##.....................###......................#####...#####........####........#####..........#####...................#####
##.#......####...........####......................#####....####........###.........#####..........######...................####
##.#....#######.........####........................###.....####........####..##.....###............######...................###
##.##..#########........###.................................####........#########..........###.......#####....................##
##.##..############......................##...###............##..........########.........#####........##......................#
##.#...#############....................#########...........................####..........#####................................#
##.....############.....##...........#############.........................................###................................##
##.....############...#####.......##################..................##.......................................###..........####
#.....############...######......#####......############..............#........................................###.........#####
#.....############..#######......####........############.............................##.......................###.........#####
#......##########...########.....####........############............................###......................####........######
##........#######....#######.....#####.......############...........................####......................#####.......######
##..........#####.....#####......######.......##########...........................####............##........#######......######
##...........###.................#######.......#########..........................#####...........#####.....#########.......####
##...............................########........########..........................###............######...#####..##........####
##..............................##########..........#####..................#......................######...####.............####
##..............................#########............###..................###....................#######....##.............#####
##..............................######........................................................##########..................######
##..............................#####.....................##.................................###########..................######
##..............................#####.........##.........#####...............................###########..................######
##.#####........................######........##..........########............................#########.....####..........######
##.######......................########........##...###...#########...........................#########....######..........#####
##.######......####.........################...#########.###########..........................##########..########..........####
##.######.....######........################...########.############..........................####################...........###
##.#######...#######........###..##########....######....###########..##......................##############...##............###
##.################...............#########...######......##....###...###.....................#####..######..................###
##...#############...................#####....#####...................####....................###.....###...................####
##......#########.....................####....#####....................###...........#########..............................####
##.......########......................##......####.....................###........###########.............................#####
##......##########..............................###.....................###........##########.............................######
###...#############..............................###...##...............###...####.##########............................#######
###########....#####..............................########...............#...#####.##...######..........................########
#########.......#####....................######....########.................######.#.....#######.......................#########
##..####.........#####..................#######.....#######.................######........########....................##########
#....###.........#####..................#######.....########...............................#########..................##########
#.....##.........#####....##............#######......#######..................................#######....................#######
#.................###.....##............######........#######..................................#######....................######
#.........................##............#####.........########.....................................##......................#####
#........................###...........####..........#############.............##..........................................#####
#........................###..........####.........################...........###..........................................#####
#....................................####........######........####..........###...............###.....###............#...######
#......##............................###........######..........###..........###..............#####....####..........###########
#.....#####..........................####.......######..........###..........####.............#####....####..........###########
#.....######.........................#####......#######.........###.........#####.............####......##...........###########
#.....#####...............##........#######......#####...........##........#####...............##....................###########
##.....###...............####......########......................###......#####......................................###########
##......................#######....#####........................#####....#####......................................############
##......................########...####.........................#############...##........##........................############
##...###.................#######....##.........................#############...#####.....####............##.........############
##..#####.................#####................................###########.....######.....##............####.........###########
##..#####.................#####.................................#########......#######................######....#.....##########
##...####................#####..................................########.......########..............#######..####.....#########
##....##................#####...................................#######.......#########..............######..####...........####
##.....................#####....................................######.......##########..............#####...###.............###
###....................####....................................#######......#####..####..............#####...##...............##
####..................####..............#......................######.......####....##..............###########...............##
####................######.............###......................####........###....................###########......##.......###
###...............#######...............#........................###..............................############......##......####
##..........##...######...........................................................................###########.......##......####
##.........###########..........######..................................................##...#....#####.##..................####
##.....###############..........#######.................................................#######..#####.......................###
##....###########..####.........######..................................................#######..#####........................##
#.....##########....####...................................................................####...####..................##....##
#.....########......####....................................................................###....##..................####...##
##....#######......######..##.................##............................................###........................#########
##....####........############...............####....................................###...###................##......##########
##....###.........############...............####...................................#########................###.....###########
##....###..........###########..........#.....##...................................#########.................###....############
#.....###...........##########..........###.........................................########................####..##############
#......###..........###########..........###......................#.....................####...............#####################
##.....###..........############.........####....................###.....................####...............####################
##.....###........##############.........#####............##.....###.....................####.................##################
##....####.......##############..........######.....#########....###....................#####.....................##############
##....####......###############...####....#####....###########...###......##.......##..######..........###.........#############
#......####....########################.....##.....#####..#####.####.....###......####.#######........#####........#############
#.............###..######################...........###....#########....####......####..######........######........############
##...........###....###############...####..........##......########...####.......####...#####.......########..........#########
###...........#.....#####..#######.....####.........##.........####....###.........##....######..######..#####..........########
###.................####....#####.......###.........##..........##.....###................############.....####.........########
###..................##.....#####.......###........####.................##.................###########......###..........#######
##....###....................####.......###........####......................................#########......###...........######
##...#####...................###.......#####........##........................................#######........#.............#####
##...#####.............................######......................###...........E...............####.......................####
##....####............................########.....................###............................###........................###
##......###......###..................########.....................###..................##.........###........................##
##.......####...####..................#######......................##..................###..........####..................##.###
##.......#####..###...........###.....######..........................................####...........######..............#######
##.......#####...#...........#####.....#####..........................................#####...........#####..............#######
##........####................####......####..........................................#####............####.............########
##........#####................###.......###.........................................#######...........####............#########
##........#####.................##........#.....................##..................#########.........######.........###########
###......######.................###....................#####...####...............############......########........############
################......#######..#####..###............###############.............##############....#########........############
#############################################################################################################......#############
################################################################################################################################
