################################################################################################################################
###.#.#......#.#.#.###.###...#..#.#.#####..........#.#.#...........#..#.#..##.#.#.....#.......#.##.#.#.#....#.######......#.####
##......................###.........#####.......................................................................#.............##
###......................#.....................................................................................................#
###............................................................................................................................#
#..............................................................................................................................#
##.............................................................................................................................#
#..............................................................................................................................#
##.............................................................................................................................#
#..............................................................................................................................#
##.................................................................................................................#...........#
#................................................................................................................##............#
##..............................................................................##.#............................#.#...........##
###..............................................................................#####............................#............#
###............................................................................#.###...#......................................##
#...............................................................................##..#.#........................................#
##....................................................................................#.......................................##
#..............................................................................................................................#
#.............................................................................................................................##
###............................................................................................................................#
#.............................................................................................................................##
###............................................................................................................................#
#.............................................................................................................................##
##.............................................................................................................................#
#............................................................................................................................###
#..............................................................................................................................#
#.............................................................................................................................##
#..............................................................................................................................#
#..............................................................................................................................#
#..............................................................................................................................#
#..............................................................................................................................#
#..............................................................................................................................#
#............................................................#.#...............................................................#
#.............................................................#................................................................#
#..............................................................................................................................#
#........................................................................................................#.....................#
#.........................................................................................................#...................##
#........................................................................................................#.....................#
##............................................................................................................................##
#.....S........................................................................................................................#
##............................................................................................................................##
##.............................................................................................................................#
#.............................................................................................................................##
##.............................................................................................................................#
#.....................................................................................#.......................................##
##..................................................................................#..#.......................................#
#....................................................................................##........................................#
##.....................................................................................#.......................................#
#..............................................................................................................................#
###............................................................................................................................#
####...........................................................................................................................#
###..........#.................................................................................................................#
##..........#.#................................................................................................................#
#..............................................................................................................................#
##.............................................................................................................................#
#..............................................................................................................................#
##.............................................................................................................................#
#..............................................................................................................................#
##....................................................................#........................................................#
#.................................................................#.#..#............#..........................................#
##.................................................................####.............#.#.......................................##
#...................................................................#..............#####.......................................#
#...................................................................................#.###......................................#
#.....................................................................................#####....................................#
#....................................................................................######....................................#
###..................................................................................#.#####...................................#
###..................................................................................#.#..#....................................#
####................................................................................#....#.....................................#
###.#.#........................................................................................................................#
###....###.....................................................................................................................#
#........#.#...................................................................................................................#
##......####...................................................................................................................#
#.........#.#.................................................................................................................##
#..............................................................................................................................#
##............................................................................................................................##
#..............................................................................................................................#
##.....................................................................#......................................................##
#....................................................................##........................................................#
#......................................................................##......................................................#
###....................................................................#...................................................E...#
#..............................................................................................................................#
##.............................................................................................................................#
#..............................................................................................................................#
##.............................................................................................................................#
#..............................................................................................................................#
##.............................................................................................................................#
#..............................................................................................................................#
##..............................#..............................................................................................#
#.............................##...............................................................................................#
##.............................................................................................................................#
#..............................................................................................................................#
#..............................................................................................................................#
#..............................................................................................................................#
#..............................................................................................................................#
#..............................................................................................................................#
#..............................................................................................................................#
#..............................................................................................................................#
#.............................................................................................................................##
##.............................................................................................................................#
##..............................................................................................#.............................##
#..............................................................................................#...............................#
#..............................................................................................#.#.............................#
#...............................................................................................#.#............................#
#...............................................................................................#..............................#
#..............................................................................................................................#
#.............................................................................................................................##
#..............................................................................................................................#
#..............................................................................................................................#
#...............................................##.............................................................................#
#..............................................#.#.#...........................................................................#
#................................................###...........................................................................#
#..................................................#...........................................................................#
#..................................................#...........................................................................#
#..............................................................................................................................#
#.............................................................................................................................##
#..............................................................................................................................#
#...........................................................................##.................................................#
##............................................................................#................................................#
#..............................................................................................................................#
##............................................................................................................................##
#.............................................................................................................................##
#...................................................................................................................#.........##
#..................................................................................................................###.......###
#...................................................................................................................###.......##
#..................................................................................................................###.....#####
#...............#..................................................................................................#####.#..####
###.#.#.#.#.#.#.#.#............##.#.#..#.#.#.##.#....#.#............#....#..#.........................#.#.......#.##############
################################################################################################################################
