################################################################################################################################
#######.#...#######################.########.#.######......###########........##################.#.#.##.#...#.#######.#.#......#
#######...........#.##############....######....####............####...........#.#..#########.##..............#####...........##
#####................############.....#####.......#..............####..........#.#.#######.#...................###.............#
####.#...............#..##########.....####....##.................###............#....####.......................#............##
####...................#########......######.#...#...............######..........#...###.......................................#
##......................#.##.####......####.#.#.#.#................#####..............#.......................................##
###............................#.....######.#.#...#..#............#.#.###......................................................#
#.....................................#####..........#..............#..#..#...................................................##
##.............#.......................#####........#...................#.#.#..................................................#
#...............#.......................####..............................##..................................................##
##.............#..........................##............................#.#....................................................#
###...........#..........................##..............................#.....................................................#
##.............#...............................................................................................................#
###...........................#.#.............................#.#.#............................................................#
#............................#.##............................#######...........................................................#
##............................................................###.#............................................................#
#..........................................................#.####..................#.#.#.......................................#
##......................................................##########..................###........................................#
#.................................#.....#..............#.#######...................####..............#.........................#
##.................................#.#.#.............................................#..............#.........................##
#..............................#.#.#.####...........................................#................#.........................#
#..............................#.#.###.#.#.........................................................###.#......................##
#............................#.#####.#...#.........................................................####.#......................#
#..........................##.######.............................................................######.......................##
#......................#.##...###.#.............................................................########.......................#
#.......................###....##................................................................####........................###
#......................#..#....................................................................#######........................##
#......................................................................................###.......####........................###
##......................................................................................##.....###.#..........................##
##.....................................................................................####......................#...........###
##.....................................................................................###.....................##.............##
####...................................................................................#..#...................###.#..........###
##..........................................................................................................####.#.............#
###...........................................................................................................#...............##
##.........................................................................................................##..................#
##............................................#...........................................................#.##.................#
##..........................................#.#.#.........................................................#....................#
#......................#...................#.#.#.#.............................................................................#
#......................#.#............#####....................................................................................#
##....................###.#................#...................................................................................#
#......................#.................##.........................................................#...#....#.................#
###........................................#.........................................................#####....#..#.............#
##.........................#.....................................#.#...................................##....#..###............#
####......#..............###...............##...................#####..................................#.#.....####...........##
####....##.#............####.#.............#.....................###.....................#.#..................#.###............#
##########...............###..#.............#............##.......#......................#.#.#..................##............##
###########...............######...........#...........#.##.#.................##.........#..#..................#.#.............#
##########.................#####..........#............#####............#.#.##............##...................#.............###
#####..#####..............#.#.##.........#.#..........#######............#.#...............#..................#.......#.#.....##
#####....##...................#.........#..............####.............#...#..........................................##.#.####
###........#..........................................#..#.##............##..................................#........###.#.####
###...................................................#.#..............##...................................###........#.#....##
#..........S..................................#................#........#.#......................#...........##..............###
##..........................................##..................##......#.#.......................#..........##................#
#..............................................................#.......#####.....................##.........###................#
##..............................................................#.......###.......................##........###................#
#..............................................................###.....#.##.#.......................#...#.######...............#
#...............................................................#........#.#.......................###.#######.................#
##...........#......................................................................................#.########..#..............#
#.............###.....................................................................................#######..#...............#
##............#.....................................................................................######.#.##.#.............##
#...................................................................................................###..#....#................#
##.........#..#...........#.#..#....................................................................####.....#...............#.#
##.......#.#####.........#########.........................................#.........................#.....................#.###
#.....#.#######..........##########........#.........................########...............................................####
#......########...........########..........#......................##########................................................###
#....#####.##.............########.#.........#.#....................###.#.#####................................................#
#......#.....###..........###.#.#.#..........#.#...................##.....#.#...................................#.............##
#......................###.##................##....................##.......#.................................##...............#
#........................#..................####...................#.......#...................................###.............#
#......................#.#..................##......................#.........................................#..#.............#
#......................#......................#....................#...........................................#..#...........##
#.....................###..................###...................................................................#............##
#................#.##.##....................................................................####.............................###
#.................#..#.......................................................................###.#............................##
#...................#......................................................................#######...........................###
##..........................................................................................#######.................#.........##
####......................................................................................#########..................#.......###
###...........................................................................#.#.#.......##########..................#.......##
####...........................................................................#####.....##.#.######....................E.....##
###............................................................................####......##...######.........................###
###.#...........................................................................#.#.............#####.........................##
####..........#....................................................................#.....#......####.........................###
##.#..........##.......................................................................##.........###.......................#.##
##............##.#....................................................................#............#........................#.##
#.............#.#......................................................................#..........#...........................##
#......................................................................................#...........#..........................##
#.............................................................................................................................##
#.................#...#........................................................................................................#
#..............##.###..#.............................................................................#####.....................#
#.............#...#####..#..........................................................................####.......................#
#................#..#..#####.........................................................................#..#......................#
#.................#......###...................#.....................................................##........................#
##......................#####................#.#.#.#..............#............................................................#
#...........................#.#...............#########..........#..............#........#.......................#.............#
#.........................#..#...............########.............#..........#...#........#.......................#............#
##........................#.##...............####.#..............#.#.#........##.#.......#......................#.#............#
#.........................#...................###...................#..#..........#..............................#............##
##.......................#####...............#.......................##.#......................................................#
###.......................###...........................................#.....................................................##
####.....................######.........................................#......................................................#
#####.....................######..........................#............##......................................................#
######.....................#####.........................###...........#.......................................................#
#####.....................########........................#...........#........................................................#
#####....................########..............................................................................................#
####.............##################............................................................................................#
#####.............##########.####...............................................#.#.#.#.......................................##
###..............##########....#####..........................................#.##.#.#.........................................#
####.............#########....###...#........................................#.#.#.#...................................#......##
###.............####.#.##......####.................#.......................#........................................#.#.......#
##...............###...###......#.........#.....######......................##...............................#........###......#
##..............#####.#.#..................#.....######......................................................#......#####......#
#................###.....#................#.#...########......................................................#.....#.####.....#
#.........#......####.....................#.......#####.....................................................##........#....#.#.#
#........#........##......................##.....###.#.#...............................#....................#..........##.#.####
#.........#......#................................#...................................#..#..................#...............####
#.............................................#........................................####..................................###
#............................................#...........................................###................................####
#.............................................#.........................................###..................................###
#.............................................................................#.#.#........#..................................##
##..........................................................................########..........................................##
#..#.......................................................................########...............................#............#
###.......................................................................##########............#.................#.#.#........#
####.....................................................##...............#########............####........#......#####.......##
######........#..................#..............#.......####............############......#.#.#######.#..#.#.....#########....##
######.#.#######.#.#.#.........#####.#.#.#.#..#.#.#.#.#######.#.#.#.#.#.############.#.#.#################.#.#.#.#########..####
################################################################################################################################
