################################################################################################################################
#############....................................................................................................###############
########......##########...#######..........###.....###.....##############.....#######........##################......##########
#####.........#########.....#####....................##......#####...####....S..#####...........#########..####........#########
####..........#########..............................##......#####....###.......#####............########...##..........########
#####..........#######..............................###.......#####...###.......####.................####................#######
######..........#####...............##.............####.......#####...###......####...................####................######
#######..##.....####.....###.......####............#####......####...###......#####...................#####................#####
############.....##.....#####......####............#####......###....##.......#####...................#####..................###
###########.............#####......####.............#####............##........####..................#####..........###.......##
#########................#####......##..............####.............##.........####...............#######.........####.......##
########..................####.......................#...............##..........###...............######..........####.......##
########..................###..............................##.....................###...#####......#######..........##........##
########...................##.............................###......................##..#########......#####...................##
########...................#...............................##........................###########.......####...................##
#######...................##.......##................................................###########.......####...................##
#######..................###.......##.................................................#########........###...................###
#######..................####............................................................######.......####......##.....#########
########.................###...............................................###............#####......######.....##....##########
#########.............................................##......#............####...........######.....#######...###....##########
##########...........................................####....##...........######..........######......############....##########
############...............................###.......####...####.....############.........#######..........########..###########
#############..............................####......####..######...#############..........#######..........####################
####..######................................##.......####..######...#############...........#######.............################
###....####...........................................##....#####....#######..##......#.........####................############
###....###.............####.................................######.....####..........###.........###................############
###...####.............#####.....##..........................#####......###..........####.........#................#############
###...#####.............######...##............................##........##...........###..........................#############
####..#######...###.....#######.##.....................................................#...........................#####..######
####..#######.######...###########................................................................................#####....#####
####...######.####################......#........................................................................#####.....#####
#####....####.############..######.....###.......................................................................###.......#####
####......###.###########....#####......###.......................###............................................##.......######
##........###.###########................####.....................####.....#..............................................######
#........####..##########.................#####...................###.....##..............................#####............#####
#.......####......########................#######.......#..................#..............#####..........#######...........#####
#.......####........######.................#######......##...............................######.........#########..###......####
##.......####........####......................####...........###.........................#..##.........####...########......###
###........##........###........................##............####..##..................................###......######......###
###.........#........##................###....................########......###..........................#........####......####
####................###...............#####....................#######....######...................#.....................#######
######.............####...............#####....................######....#######..........####....###........##..........#######
#######............####.......###.....####.....................#####.....########........######....#........####.........#######
######..............##......######.....##.......................####.....############....######............########.......######
####.......................#######...............................##.....#############.....#####............########........#####
###.......................########............###......................##############......................#####...........#####
##.............##........########............####.......................#######............................####......#....######
#.............####.......#####..............####.............##............###...........###........................###...######
#.......##....####........##................####............######.......................####..........#............###...######
#.......##....####...........................##..............#####........................#######......##............##....#####
##......##....####............................................###..........................######................###........####
##............#####.#........#####.............................................#.............####...............####........####
###.........#.########......######............................................###.............##.................####.......####
###.......###.#######......#######.....#.........#............................###.......###.......................####......####
##......#####.#####........#######....###......####..........................####......#####.......................####.....####
##.....######.####..........#####.............####........###................####.......#####......................####.....####
###....######.###.............................###........#####................##.........#####............##.......####......###
####....#####.###.............................###........#####.........##................######..........###........####......##
####......###.##.....##......................#####........####........#####.............................####........####......##
####........#.##....####.....................######........##.........######......###..................####.........####.....###
####..........#.....#####.......###...........#####...................########....###..................####.........####....####
####................######......###...................................########.....###.................####.........#####...####
####.................#####......###....###............................#######.......###.......###.......##..........#####....###
####..................###........#.....###...........##...............######.........###.....#####...................####.....##
###...................................####..........####.............#######..........#......######...................##......##
##............................##......###..........#####...........########...................########........................##
##...........................####..................####...........############................#########.......................##
###.........................######..................##............##############..............##########......................##
####.......................#######.....####......................################.............###############.................##
#####......................######.....#####......................####...########...............###############................##
######....................#####.......#####.......................##.....####...................###############...............##
######...................#####............................................##.....................##############..............###
######...................###..............................................##......................#############..............###
######...................##.........................#....................###.......................##....####................###
#####..............................................###...................###.................................................###
####........#.##...................................###....##........................###......................................###
####.......##.###...............###.................#....#########..................###.......................................##
###........##.####.............######....................##########.................###..........##.............###............#
##.........##.####..............######...######...........#########.................###.........####.............#.............#
##.........##.####...............#####..########....##....##########............................#####..........................#
##.........##.####...............#####..########...####....#########............................#####.........................##
##..........#.#####..............#####...######....####.......#####.............................####..........................##
##............#####...............####....#####....####.......................................#####.........##................##
##...##.......#####........................####....###.......................................#####.........#####..............##
###.####......#####.........................####..####.......................................####.........#######.............##
########......######..##....................##########......................................E###.........#########............##
#######.....#.###########..................##########........................................###.........########.....##......##
#####.....###.###########.................#########.................###.......................#.........####.........###......##
####.....####.##########.................##########...........##.....#..................##..........#######..........###......##
###......####.......####.................##########..........####...................######.........#######...........###......##
###......###.........####.................##########..####..#####..................#######.........#######............##......##
###......###.........#####.................######################..................######...........######....................##
###.......##........##########.............######################..................#####............#####.....................##
##.........##......###############..........#####...############...................#####....###....####......................###
##.........##......#####..###############....##......###...####.....................###.....###.....##.......................###
##........###......####....###############...........##.....###............................####...............................##
##.......#####......###....######..########.........###.....###..............#####.........####...............................##
##......#######......###....####....#######........#####....................#######........####...............................##
###.....########.....####...###.......#####.......######....................########..##..####................................##
###......########...#####...###.........####......#####........................###############...............................###
###.........############................#####.....###..........................################............................#####
####.........###########.................#####....##..........................##################..####....................######
######.........####..##..................#####....##..........................############...##########..................#######
#######.............................#.....#####..###...........................##########.....##########.................#######
#######............................###.....#########...........................##########......#########.................#######
######.............................####.....#########...#......................#########......#########.................########
#####...................####.......####......########..###....................#########......#########........###......#####..##
####...................######.......##........#######...#....................##########.....########.........####....#######..##
###......##.........#########.....................##............###........############.....#######.....##...#####..#######...##
###........#.......###########.................................#####......################..######.....####..##########.......##
###........####..#############..................................####.....##################...###......####..#########.......###
######.....###################....................................##......##....#############..........####..#########......####
######.....##################....................................................############...........###.#########......#####
######.....##################........##...........................................################.........##########..#########
######....############..#####.......####...###....................................#################.......##########...#########
#######...############....###.......###....####...##..............................#################.......###...###....#########
##..###################....................##########.............................################........##...........#########
#....###################....................#########..................######.....########..#####......................#########
#.....###############..##....................#########................########....#######................#............##########
#........######...##....#####.................########.........###...#########...########...............###.....################
##.......................######................######.........###############....#######................###....#################
##..........................###...............................##############.....#######...##...........###...##################
###..###........###...............................................##########......######..####.....##.........##################
#########.....#######..............................................#########......######..####.....##........###################
#########....#############.........................................##########.##.#############.....##.......####################
##########..##################..................###.......###......############################...####.....#####################
###############################.........#######################..######################################..#######################
################################################################################################################################
