################################################################################################################################
########...................................................................................................................#####
####........##...##############...#######....#########.....#########.......######.....######.......#####..############.....#####
####........##....############......##........#...###......########........#####.......####..........##..........####.......####
####........##...#############............................########.........####.........##........................##.........###
#####......###...##############...........................#######.......######...............................................###
######....####...########..#######........................#######......####.................##...............................###
######...####.....######.....#######......................########......##.......###.......####..............................###
#####...###........#####........####.........######.......#########............######......####......###............##.......###
####....##..........####.........###........########......########............##########....###.....#####..........#####.....###
####....##...........##.....................########......#######............###########.....##.....########.......######....###
###....###...................................######........###................####...###.....##.....########........######...###
###...#####....................................................................###...........###.....#######.........#####...###
############...................................................................####..........###......#####..........#####...###
#######..#####.#...########....................................................#####.........###.......####.........######...###
######....####.#############...................................................######.......###..........###........######...###
###.......####.#############...............................##..................######......####............##........#####..####
##........####.############....................###.......#####.................#######...#####.............####.......####.#####
##.......#####.##########.....................#######..#######................###############......##.......####........##.#####
##.......#####.#########......................###############........####....###############.......##.......####.........#.#####
##........####.########........................#..#########.........#####....#####.....###...................##............#####
##.........###.####................................######............####....####..................................#.........###
###........###.###.................................#####.............####....####.................................##..........##
####.......###....................................#####..............#####..####...................................#..........##
#####......###..................................######..............###########..............................................###
#####...................###....############....######.......##...#############...........................................#.#####
####...................#############################.......###...######..####...................#...#####...............##.#####
####.................##############################.......####...#####...####..................############.............##.#####
####................################.....#########........###......##....###...................#############............##.#####
###.................##########..###.......#######........................###...................#############............##...###
###.................#########.............######.........................###..........###......##############..##.....##......##
##..................########.............######...................##.....###..........####....###################....###......##
##...####..........########...........########...................####....###..........##########################.....####.....##
##...######.......########...........########.......##..........#####....###..........#################...#####.....######....##
##...#######.....########............#####..........##.........######....###.........#################.....#####...########...##
##...#########.#########..............###..........####......########....###.......#######..#########......################...##
##...#########.####...............................######....########.....###....##########..................##############....##
##....##...###.###..............#..............#########....####..........#....############.................######....####....##
##.........###.####............###............#########......##.................############................#####......####...##
#.........####.####............###...........#########.............................#########................###........#####..##
#.........####.###..............##...........####................##......##.............#####..........................######..#
#..............##...............###...........##................####....####.............######.....##..................#####..#
##.............##................###......................##....#####...####.............#######...####..................####..#
##.............###.....#####......##.....................####..######...###.....##.......#######...####..................####..#
##.............###.....######............................###########.....##....####.....###..###...###..................########
##...........#.##......#####..................#..........##########......###..######...###..........................############
##..........##...............................###.........#########........################.........................#############
##..........##...............................###........#####..###.........################.........................######.#####
##.........###...............................###........####....##..........####...########...........................###...####
##.......#####..........................##...............##.....###.....##...##.....########................................####
##.......####..........................####....................####....####..##.......######................................####
##.......###.....................##...#####....................####....####..###.......#####................................####
##..............................###########.....................####..#####...###......####.................................####
##.............................#########..........###............##########....###....#####................##...............####
##.............................#######...........######..........##########....####..######...............##................####
##.............................#######.........#########.........###########..#####..###...###...........###.................###
##.......##.....................######..##....#########..........#################...##....####..........###..................##
##......###......................##########...######..............##############...........######........###..................##
###.....###...........####........#########....###......................#######............#######.......##...................##
####.....##..........######........#######...............................#####.............########.....###..................###
####.....###.........######..........######..............###..............###..............########......#...................###
####......#.........#######...........######.............#####...##.......###.............########...........................###
###................#######............######.............###########......###.........############............................##
###...............######...............####.................########.....####.........###########..........######.............##
###..............######.................##...................######......####..........#########..........########............##
####..###.......#######........................................####......####...........##...##...........########............##
#########.......#######.......................#.................###.......###............................#########............##
#########.......########....................####...............####.......###............................########.............##
#######............############............#####....###........####........##............................########.....##......##
#####................#############........######...#####........##.........###............................########...####......#
###...........................#####.......#####....######..................###.............................#######...####......#
##.............................####.......####......######.................##..............................#######....##......##
##............S.................##........###........#####.................##..............................#######............##
##.......###...............................##.........###..................###....................##........######............##
##......#####...............................##.............................######.................###..........###............##
##......#####...........##..................#######........................######.................####..........###..........###
##......#####...........###.................########......................###.....................####..........####.........###
###......###............##......###.........####################.........###.......................###...........####.......####
####......##....................###........####....##############.......###...........######......................##......######
####......##.....................#.........###......#############......####..........########............................#######
####......##...............................###.......###########......#####..........########............................#######
####.................###..............................#####..........######...........#######............................#######
####................#####.............................#####..........#####.............######............##..............#######
#####................###..............................#####..........#####..............#####...........####..............######
######.......................#####....................#####...........###................###...........#####.........E........##
#######.....................######....................#####...........###.............................#####...................##
#######..............##.....######.....................####............#........................##...#####....................##
######..............####.....###.......................####.......................###..........#########......................##
#####...............####................................##........................###..........#######........................##
#####................##..........................................................####.........######..........###.............##
#####............................................................................###..........#####..........#####............##
####...................................................................###..................................#######...........##
####........................###...........##................####......#######.....................##......#########..........###
####.......................####...........##...............######.....#######....................####....##########......#######
#####.....................#####...##.................##....######......######....................###....#######.........########
######..#.................#####..####...............####...#####.......#####........###...........#....#######.........#########
##########...............#####...####...............####....###........####.........##########.........######..........#########
####..###................####.....###...............####..............####..........###########.........####...........#########
####......................##.........................##...............###............###########........................########
####.....................................######.......................###.................######........................########
###########..................###........#######.......................###..................####............####.........########
############................#####.......#######........................###..................##............######.........#######
############...............########....#####............................#................................#######...........#####
###########...............#################.................###..............##.......................##########............####
#####.....................#####...#######..................#####............####.....................###########............####
#####.....................####.......###...................#####............####.....................#####..####.............###
#######..................#####..............##.....#####....###..............##......................####....##..............###
########.................####..............####....######...........###..............................###.....##.............####
########..................##...............####....#######.........####.....................................##.............#####
########............##......................##.....########........####...................................................######
########.........######.............................########........##.................................##.................######
#######.........#######................#.............########........................................####...........###....#####
######..........#######...............###............########.......................................#####..........#####....####
##.............#######................####.....###..###...##.................................###..#######.........######.....###
#..............#####..................####....#########..................###................############.........######......###
##...........#.#####..................####....########...........####....###.................###########.........#####.......###
######.......#.######......###.......#####.....#####............######...####.................##########....##....###.........##
#######......#.######.....####......######......##...............######...#####.........##....#########.....###...............##
#######.....##.#######...#####.....#######.........................#####.#######.......###.....###...........####.............##
######......##.###############....#######...........................############......####.....##............#####............##
##..........##.##########.........#####...................###........#######..#.......####.....##...........#######...........##
##.........###.##############....#####...................####.........#####...........####.....###........##########..........##
##........####.....########......####....................####.........####...........#####......#.........###########........###
###...#######.......######.......###........###...###.....##.........#####.........#######................############.......###
#############.......######......####.......###########..............######........#########...............#################.####
##############.....########...######......##############....################.....############...###......#######################
####################################################################################################..##########################
################################################################################################################################
