################################################################################################################################
######################################################################################################################.....#####
################.............................................................................................................###
################........#####....#######..######..###############..................######......##############..######.........##
################........#####.....###......####....#########..##....................####........############.....#####........##
########.#########......#####..............####........####...........##.............###.........##########.......#####......###
#######...#########....######.............####..........##...........####.............##..........########........##############
######....#########...#######............#####......................#####.............##...........######..........#############
###.......#########...########..........#####.......................####.............###............###.................########
##.........########....##...#...........####.........................###............###......#...........................#######
##..........#######.....................####.........................####............#......####............................####
##..............####.................#..####.................###....#####....................###.............................###
#................####...............##...##.................#############.....................##..............................##
#.................###.......................................#############................................##...........#.......##
##.................#.......................................#############.....###........................###..........###......##
##..................................................###...#########..........###......................#####.........#####....###
##.................................................#############.....................................####...........############
##........................................###......############.....................................#####..........#############
###.......................................###......############.....##............................#######..........########..###
####.......................................#.......############....####..................S.......###########.......#######....##
####.............##................................############....####.......................###############.......#####.....##
####............####.............####..............###########......##.............##..........##############.......####......##
####............####............######............###########..............##.....####..........######..#####........##......###
###.............####......#.....######...........#######...................####...####..........#####.....###................###
##...............##......###.....##.............#######....................#####..####..........#####......##................###
##.......................##....................########..........##.........####..####..........######.....##...........###..###
##..........###.........###................#############........####.........##...####...........######....##..........#########
###.........#####.......###..............########....###......#######............#####...........######...###.......############
####.........#####......###............#########......###....############.......######............####....###......#############
####..........############......##....#########........###..################....######....................###......####..##...##
###...........############......###...#########........###..###...###########...######....................####.................#
###..........############.......###....###...###......#####.###...###########....####......................####................#
###.........############........##............###....######..###..###...#####...............##..............####..............##
###......########.............#.##............###...#######...#...###....###........#.......##................###.............##
###.....#########.............#.##.............###..#######........##..............###......##.................##..............#
##......##########............#.###.....#......###...######........###..............#................##........###.............#
##.....###########..............###....###......##.....####........####.............................###.......####.............#
#.....###########...............####...###.......##.....###........#####.........................######......####.............##
##...###########................####...###.......###....###.......######........................######.......####............###
################.................##...###...###...##.....#.......######....................##...####.........####............###
#######....#####.............##.......###..#####..###...........######....................####..####........#####...........####
#######......####...........###......####..#####..####.........######....................#####...###......#######..........#####
########......####...###....###......###....###...####........#####.....................#####.....##############..........######
########......##########....###......##..........#####........####.........#............###.......##############..........######
########.....##########......##......##..........####.........##..........###...........##.........####.....###............#####
#######.....###########.............###.........####......................###......................###.......................###
######......###########............###.........####......................###...............##.................................##
###.........##########............####........####.....................####...............####................................##
##...........###..##..............####.........##.........................................#####...............##..............##
##.................................##....##...............................................#####..............#####...........###
#........................###............####..............................................#####..............######..........###
#.......................#####...........#####.......##.............................##......###...............######..........###
##..................#########...........##############..........................#####.........................#####...........##
##.................##########..........###############.........................######..........................#####...##.....##
#....###...........#########..........#########...####..........................###.............................##########....##
#....######........########..........########......####..........................................................#########....##
##..########........#######..........###...........#########..##....................................................######.....#
#######.#####..........####.........................############.........##.................................###......####......#
######...####...........##..............................#######.........####.........................#.....#####.....###.......#
#####....#####...........................................#####..........####....###.................###....#######...##........#
####....#######...........................................###...........###.....####...............####.....#########..........#
####....#######............###.........................................###......#####.............#####.........#####.........##
#####...#######....##......###.........................................###.....#######.............###...........#####.......###
#####....#####....####.....##................................###......#####....########..........................#####.......###
#####.....###.....####............#####......................###....######.....########...........................###........###
#####......##.....####...........#######....................####...####...........#####.......................................##
######.....##.....###............########.........####......####...###.............####.......................................##
######....###.....##..............#######........######....#####...###..............###..........###..................##......##
######...####......................#####.........######....####....##................#............#..................####.....##
#####....####.......................###...........####......##....##.......##........................................####.....##
#####.....##........................###...........................##......####..............###......................#####...###
####...............................####..................................#####..............###.......................##########
###...........................#.#######.....##...........................####.......###.....###...............###......#########
##...........................##.######.....###............................##.......#####...####...............###.....##########
##...........................##.###........###......................................####..#####...............###....######.####
##............................#.#.......................................................######...............####....#####...###
##......................................................................................#####...............####.....######..###
#.......................................................................................####................####.......####..###
#................................####...........................####....................###...##.............###........##...###
##..............................######.........................######....................#...####............####............###
###..........###................########......................#######........................####.............####...........###
###.........#####................##########........###........#######........................####..............###.....##...####
##.........######...........#....##...######......#####.......######.................##.......####..............##.....#########
##........######...........####.#......#####......####.........####................#####......#####....................#########
##........#####.............###.#.......####......###............................#######......######.....................#######
##.........###...............##..........##.......###...........................########.....#######.............##..........###
##...............................................####..........................#######.......######.............####..........##
##...##................##.......##............#########.....................########........#####..............######..##.....##
##..####..............####......###..........###########....................#######.........###...............############...###
##..#####.............####....#.###....###....##########....................#######......................###########..####...###
##...#####.............##.....#.##.....###.......######.....................#######.....................##########.....##.....##
##....#####...................#.##.....###........#####................###.#######......................#########.............##
##.....#####..................#.##.....##......#######................##########.........................#######.............###
##.....##########.............#E##.....##.....#######.................####..###.............................................####
###....##########........#...##.##.....#......######.........##.......###...................................................####
####..###########........######.##....##.......######.......######....##...........######............................##......###
################..........#####.###..###.........#####.....########...##..........########..........................####......##
########...#####...........####.########..........####.....########...###.........########..................###.....####......##
#######.....####............###.#########.........#####.....########..###..........#########.......###.....#####.....##......###
##.####......###.................########..........#####.....#######..###..............######.....#####...#######...........####
#...###...........................#....###............##......#####....##...............####.....################...........####
#.......................................###...................###.......##.......................################...........####
#.......................................###...................##.........##......................#################..###.....####
#..............................................##............###.........###......................######################....####
#..............................................##............###.........###..................##.................########....###
##..#####..................##............................................####................####.................#######....###
##########................####...##................................##.....#######............####..................#####.....###
##########................#####.#####...............###...........####....########...........####......####.........####.....###
###..#####................#####.######.............####..........#####.....#######...##.......##......######........####.....###
##....###..................####.#######............####..........#####......######..#####.............#######........##......###
##.........................####...#####...........#####...........####.......####...#####..............#######...............###
#.........................####.....#####........######.............##........####....####..............###########..........####
#........................#####.....#####.......#######........................##.....###..............#############........#####
##......##............########......####.......########.......................##.....###.............###############.......#####
##.....####...........####..###.....#####......#########.......................##.....#.............#####.#########.........####
##.....#####..........###....###.....######....##########......................###.........##.......####...######...........####
##.....######.................###.....###################...........###........####......####......####.....####.............###
##....##########..............####.....##################..........#####.......####.....####......####.......##..............###
##....#############............####....##################.........#######.....####.....####......#####.......##..............###
##....##############............####..###################.......##########...####......###.......####.........##..............##
##.....####...#####..............#########.....##########......###########...###........#.........##..........###.............##
###.....##........................#######......###...###......############....#...............................####............##
######.........................................###...###.....############.....................................####............##
#######...............####..........................####.....############......................................###.......##...##
########............#######........................#####....###############.................###................####.############
##########........##########.......####............######..##################........####..#####..............##################
#############....############################.....############################..################################################
################################################################################################################################
