################################################################################################################################
##..######...#####..###############...#############..........#########....###..#######################.....#####################
#.............###...........#####......#######..................................#####.......#########.......##########....######
#..............#.............####.......##.......................................##..........####.###.......#########......#####
#............................####..................................................................###..##..#########.......####
##...........................####................................#.................................#######...########.......####
##...........................###................................###................................#####.......#####.......#####
###............................................................####...............................####.....................#####
###............................................................####.............###...............###......................#####
###............................................................####............#####.........................................###
##.............................................................#####..........######.........................##...............##
#..............................................................######........#######........................####..............##
#..............................................................#######.......#######.......................#####..............##
#...........................##..................................######........##..#........................####...............##
##...........................#....................................####......................................##................##
##.................................................................##........................................................###
##.................................................###.......................................................................###
##.................................................###.....####....................................................##........###
##.........................................................#####...................................................###.......###
##..........###............................................#####........###........................................###........##
###.........###............................................#####........###....................................................#
###..........#.........##..................................#####...............................................................#
###...................####.................................#####............###................................................#
##...................#####..................................###.............###................................................#
##...................####...................................................####..............................................##
##...................#####...................................................####.............................................##
##....................#######..................................................###.............#..............................##
##....................########..................................................##............###.............................##
##.....................######.........##........................................#.............###.............................##
##...................................###......................................................####............................##
##...................................####........###..........................................#####...........................##
##...................................####.......####..........................................######..........................##
##....................................###......#####...........................................#####..........................##
##....................................###......#####............................................#####.........................##
##....................................####.....####..............................................####.........................##
##.....................................####.....##...............................................####.........................##
#.......................................####......................................................##..........................##
#.......................................#####..................................................####...........................##
#........................................####...................................................#............................###
##................###.....................##....................................................###...##.....................###
###..............#####....................................................#......................########....................###
###..............######..................................................###.....................########.....................##
##................#######.................................................#......................#######......................##
##.................#######........................................##..............................####........................##
##..................#####.........................................###..............................##.........................##
###..................##............................................#......................##..................................##
###......................................................................................###..................................##
###.......................................................................................##..................................##
###...........................................................................................................................##
##..................####......................................................................................................##
##.................######.....................................................................................................##
##................######......................................................................................................##
##...............######.......................................................................................................##
#.................#..S.......##..................................................................................###.........###
#.....##....................####.................................................................................###........####
##....###...................####..................................................................................#.........####
##....##....................................................................................................................####
##.....................###...................................................................................................###
###...................####...................................................................................................###
###..................#####...................................................................................................###
###...##.............#####...................................................................................................###
####.###..............####........................####......................................................................####
####..##................#........................######.....................................................................####
###..............................................######.........................#............................................###
##...............................................#####..###........#...........####...........................................##
##................................................###...####......###...........####...........................................#
##......................................................####......###...........####...........................................#
###......................................................##.......###............##............................................#
###...........................................................................................................................##
###............#.............................................................................................................###
###....#......###.............................##...........................................##................................###
###...####....###.............................###.........................................####..............................####
###...#####....###............................###.........................................####.............................#####
###...#####.....#####..........................#...........................................##..............................#####
####.######......####......................................................................................................#####
############.....####.......................................................................................................####
############......##..........................................................................................................##
##..########...................................................................................................................#
#....######....................................................................................................................#
#.....#####......................................................................................................##...........##
##.....#####....................................................................................................####..........##
##......#####................................................................................................................###
##......#####.................................................................................................#####........#####
##.....#######..........................................................................###..................#####........######
##.....########.........................................................................###..................#####.........#####
##.....########.............##.......#..................................................###..............##....####...........##
##.....#####...............####.....###.................................................####............###.....####..........##
#.......##.........#........##..........................................................####.............#......####.........###
#.................###....................................###.............................##......................##..........###
#................####............................###....####.....................................#............................##
##................##.............................###.....###....................................##............................##
###..............................................##.............................................#..............................#
###.................................................................................................#....................#.....#
###................................................................................................###...................##....#
##.................................................................................................###...................#.....#
#.............................................................................................................................##
#.............................................................................................................................##
##.........................................................................................................#...........E......##
###.......................................................................................................##...................#
####...........................................................###..##............................##.......#...................#
####..........................................................########...........................####.........................##
####..................................................##......########...........................####.........................##
###..................................................###......###.................................###.........................##
##........##........................................####......##..................................##..............##..........##
##.......####......................................####......###..................................................##..........##
#........####......................................####....####...............................................................##
#.........##........................................##.....#..................................................................##
#...........................................................................................##.................................#
##.........................................................................................###.................................#
##.........................................................................................##..................................#
##..........................................................................................#.................................##
##..................#.##....................................................................#.................................##
##.................##.##....................................................................#................................###
##..................#.##........................##..........................................##..........................########
##.............................................####...............###.......................#####.......................########
##..............................................##...............#####......................#####.....##......................##
##.............................................................#######......................#####....####......................#
##............................................................#######........#######........#........#####.....................#
###..........................................................###...........##########.................####....................##
#####.......................................................###...........####..#####..................##.....................##
######..........................................##.........####............#.....###...................................###....##
#######......................#.................###.........####........................................................####....#
#######..........###........###................###..........##.......###................................................###....#
#######.........#####......####................###..................#####.....................................................##
#######.........######.....####....##..........###..................#####................................###.................###
#######........########...##################..#####.................######.....##.......................#####...............####
########......############################################.......##########################...##....###############........#####
################################################################################################################################
