################################################################################################################################
##........#.#######.#.#.####.#.######.######################################..################.....#############################
##.####......#####...............#.........######.....##########...########....##############.............#.....#..........#####
##.####.......###...........................#####.......####.........#.#.##....####...#######.#.....#.......................####
##.###.........#.............................###.........#####.................####...###############......................#####
##...####.....................................###.........###.................####....###############......................#####
##...######....................####.........................###...............###......#####.#.######.....................######
##....#####.............#.#...#######.......................................#####.....##........####........##............######
##....######.............####.#####................................#........####.................####......###............######
##....######.............#.#####.##............#..................###......######..........#.....####...#######..........#######
##....#####..................##................##.......##.................######.......#####.....############.............#####
####.######.................###.........................##.........##......######.....#.#######........#######...........###.###
##########..................###........................###..........###.....#####.....#########........#######...............###
###########................###........................###..........####.....####.....############.....#######.................##
###########.......................................#.###.............##........##.....###########..#...########...............###
####..######.............................#........#####.....##......#.........#.....##########....#.########..................##
####....###..............................##......####.......###......................##########...#########..........#.......###
##......###.......................................##........................#.........#########..#########..........##........##
##.......#........###............................####.........#.............#...........##..#############...........##......####
##................................................###.#........##......##.#.#................############...........#.......####
#.................................................######.......###...######...................#########....................#####
##............#......................#............######.......###...######..................####...#.......................####
##..........###.....................##...........######........###...#####....................###..........................#####
##........#####.....##...........................####...........#....#######.................###............................####
####....#######....####..........................####..........##.....######..................#..........##...............######
###...#########....#######.#............................................###..............................##...............######
####...########...###.#####...................................###......................###.........#.#.###...............#######
###....#..######.......###............#........................##......................##...........##.####..........###..######
###........#####........#...........####................###...####....................####.........###.####..........#.#.#.#####
##........######....................#####...............###.....#......................###.......#.##..#####.............#.#####
##........#####.....................#####.............#####...........#...###..........###.......###....####...............#####
###.#....#######...#......#......#....####.....###...######...........########...................###...#####...............#####
#####.#.####...#######..######.###......##.....###.#.####..............########.#.............#.###.....####.................###
############..#######...###########......#.......#.#####...............#############......#########.....##...#.####..........###
############...######...#########.#......##........####..................############....#########.......###.######...........##
####.#.#.#....######.....###.####.#......##.........##.....................###.#.####.....########........#########...........##
####...........####......##............####........###......#..............###...#####....########.......########.#.........####
##......#.....#####........................................###.............##......###......#####......##########...........####
##...####.....####.......###...............................####....#.##...###......###.......####....############.........######
#....####....#####.......###....#...........................###....####....#.......###.......####...####.##########.......######
##.#####.....####.....######...#............................###....##...........#.####........####..###....########........#.###
#########...####.....######...####...........................##...###.........########........####...###....########.........###
#######.....####.....######...####...................S......##...............#########.........###...###......###............###
#####......###........####....#####.........................###...###........#########.........##....####.......##.###.......###
#####........###........#.......#...........................###..####........##########.........#....####............#.......###
###.............................##..###.....................###########........########.............######..................E###
###...................................###.#.#..............###.#.######.........#####.#.......#....######.....................##
#..............................##.....###.#####.........#....#....#####...........#.#.#...######...#######....................##
##...........................##.........######.........#####..............................#####........###.....................#
#.........##.....#..........#####.........####....##########.#...........................######........######.................##
##........##...#####........#.#............###...####...########..........................#####........#######................##
##.......#####.######.....###...###........#.....###....########.........................######.........######.....#.###.....###
###......###################......##.............###.......######......#................#######...........######.#######.....###
##.......###################......#................#..................##...............######...............############.....###
###......####################................#....###........####......#.............########...............############.....###
#..........###############..................##...######............................########..................##########........#
##.###....#########.#.####...###............##...######.....####...............#.#.#######..................###########.......##
#..........########.....##.#.###.....#......##...########....###.............###########.....................###.#.#.#...#.....#
#.........#######.......#######.....####....#.....######.....####.......################...............................#####..##
#...........#####........#####.....###......#.....####........####.....###..#########..................................######..#
##..........####.........######...................###.........#####...........#.###.....................................####..##
##..........###..........######.............##....#..........######...............#....#.####..........................#####...#
###.......#####..........#######............##...##.........######................#...#######............###............####...#
#####.....####.......###########...........########.........#####...............###.#.#######............###.#..........####...#
#######.#######.....##############..........#######...........#.#.............######....####..............######..........######
###############.....##########..............########...##....................#######......#...............#####...........######
#############.#.....########.................#######..##.....................#######....................####..............######
####..#######.....#.######...................########..##....................########...................####..............######
##....######......#######......................#####..###...###.................#######.................##................######
###.....#####....########.......................###############...................#######..........###...#...............#######
##.........#.....#######................##.....################.....##.....#........#####..........###...#.#.............#######
###..............#.#####...............###...#.################......###.#####.......####...........##...###.............#######
##.....................................###....###....##########.....#########..........##.....###........######...........######
###........................................#.#.#.......#####.#........#######.................####.......######............#####
####.......#.............................###.#...........###..........######..........#........#.........######..............###
#####.....##...............................#......................#....#####..........#..................####................###
######..###.......###.............................................#.....####..........##...#.............##...................##
#######...........#####...............#...........................#.....#####............#####............#...................##
########..............................##................####.............####............####.#...............................##
#######..............................####...............###...............##................#.#.#.............................##
######..........#...................#####.......###.....####.............#.#..................####.......##............####...##
#######........###.................######.....######....####.............#....####...........#####......####...........######.##
####....####.######................#####.....#######....####............###.########........#######....######...........###...##
##......##...######................#####.....########...####............###.########........#######....#####...........####....#
##............#####..................##.....#########...####............##########.#......#########....######..........###....##
#.............#####..........................########..#####.............#...#####.......#####.#.#.......#............#####...##
##.............##...........................####.#####..####...........#.......#..........#................####........###..####
##............#..............................#.....##...####...........##..............................................#########
####..........................####.................###..######........###.............................##...............#########
#####................#.......#####.#.#.............##..................###...........................###...............#########
####.................#......#.###...####.#........####..########.....................................####.###..........#########
####................#.........###..#######.#......###....#########.................................######.####.........#########
###.................................#########......###..#############....................#.....########....###..........########
###....#.###.......###..............####.#.#......###...#############....................#.#.####.#####...#####........#########
#.....######........##...............#...#.#.......################........#............#########...###....###.........#########
##....#######......######.........................#############............###...........######.....###....#...........#########
#.....######.........##............................###########.............###.............####.#.#.####.#.#...........#########
##.....######...........##........................#############............######.............#.########.#.............#########
##......###.#............##.................#......###########.............########.#.........#.##########.........#.#...#######
##......#.#..............#..........###...####........#.#######.....#......####...###...........#.#######.....########....######
##.......................##.........####.#####.............###......###....##.......#.................###...###########...######
##..................................####.....#.#..........####......###.............#..................#....###########...######
##..........##.......................####....###..........###.......###......................................###########...#####
#..........###......................####......##.....#....###.......##.......................##.................########.....###
#....................................####.....#.....########....##..............####.........###..................#####.......##
#....................................####............#####....#########........####.........####..................###........###
#....................................####............#.#......#####............#####.........###.............................###
#.....................................####..................########..........#####..........##..............................###
##....................................###...................#######...........##########....................................####
###....................................#...............##.#########............##########...................................####
####..................................................#########...............###########...................................####
###.............................................##.....#######.............##....###..###...................................####
###...###......................................####....#######.....###...#####.......####...................................####
##...###.......#...............................####.....######.....#####.###...........##.....................................##
##...##.......##...............................###....#..#####.....#########...........####...............#.#................###
###.##........###...................###...............########.....########.............###........###...######....###........##
#####...............................######...........#########...###########......#......#........####...########.####......####
######............#.................#######..........########....###########....###.....#........####.......#####.####.....#####
#####.............##...............########..........#######....#####.########..................#####.........#########....#####
#####..............................########..........######....#####....#.#.##..........#.......#####........#####.#........####
#...........#......................####..............########.#####.........#..........#........#####.......######..........####
##..........#............#.........##................##############...................###......#####......#######.............##
#.........#####........####.......###.................############..........................##...###....##########...........###
##........####..........###..................................######.......................######........##########...##......###
##.......#######........####...............#..................######.........###...........####.........##########...##.....####
###......########.#.#.#.####.........###...#..................#######.......########.....#######........###########.####...#####
####.#.#######################.#....##########......#.#......#########....############.#########......##################.#######
################################################################################################################################
