################################################################################################################################
#################################################################...........................................................####
######.........###################..####..######....#######..###.........##########...#####..#####..################........####
####............##############.............####......#####...............#######.......###....###....###....................####
###.............#############..............####......#####...............######..............................................###
###.............#############.............####........###.................####...............................................###
##........###..##############.........########...............................................................................###
##.......####################........##########.............................................#........#.......................###
##........##################.......#############...........................................###......###.......................##
#..........###########..###.......###############....##..####...............................###.....###..##...................##
#...........#########.............###############....##.######......##S.....................####....########..................##
#............########.............################.......#####.....####......................###....########.................###
#.............########..............##############........###......####......................###...########..................###
##............##..####..............###########.....................###......................###...######....................###
##.................###...........#############......................####....................############......................##
##...............................########..##......................########................############.......................##
##........##.....................#######...........................#########..............###########.........................##
##.......######..................######...................###.......##########............##########..........................##
##.......#########.........##.....####...................#####............###########......#########.................###......##
##........##########......####.............##....###.....#####..............##########.....##########.......##..#########.....##
###........#########.....######...........##########.....####................########......###########.....################....#
###.........########.....######...........##########.....####................######........############...#################....#
####...........##.......######............#######........####.........###....#####..........##..#######...######.......####...##
#####................#########.......#....######..........##.....##..####....#####...............######...#####..........##..###
#######.............#####..####.....###..###....................#########....#####...............######....###...............###
########.........#######....####.....######........#####........#########...#####................#######....................####
####..#......##########.....#####....######.......#######.......#########...####..................######....................####
###.........###########......#####....#####......########........########....##....................#####..........##........####
##..........##########.......#####....#####......####..##.........#######...........................###.......#######.......####
##...........#######.........#####.....###........##..............######.............###............###......########.......####
##...........................######............................#########............#####...........###......#########......####
##...........................########..........................#########...........#####.............#......###########...#.####
##............##..............########.........................##########..........#####...................################.####
##..........#####..............########..........................########....##....#####...................################.####
##.........#######.............########..............###...........######...####...#####....................#####..########.####
#.........#############........#######..............#####...##......#####...####...####.............................#######.####
#........###############.......#######..............###########......###.....##.....#...............................#######.####
#.......################.......#######..............###########.......#.....................###......................##...#.####
#......#########...#####......#########..............##########............................#####............................####
##..###########.....###.....###########...............#########...........................######.......##...................####
##############.......#.....########..#................##########..........................#######.....####...................###
##########.................######.....................##########..........................########....#####......##...........##
#########..................##..........##..#..........##########..........................########.....#####....####..........##
#########.............................#######.........#####...###.........................#######.........###...####.........###
########..............................########..#......##......###.................###....#####............###...###........####
#######.......##......................############..............#######............####...####.............###..............####
##...#........#......................############................#######...........####....##.....##......#####...........#.####
##..................................#############................#######............###..........##############..........##.####
##.................................####..#######...........##...####.................##..........##############.........###.####
##.................................###....#####...#........########..................##...........#############.....#######..###
##................................####......##...###.......#######...................##...........#############....#######....##
###.................##...........#####...........###........######...................###..........######...####....#######....##
###................####.........#####............####.........####........#####......###.........######....####.....######.....#
###...............#####.........####..............######.......###......########.................#####.....####.....#######....#
###..............######........####.................#####..............##########................###.......####.....########...#
##..............######.........####..................###...............##########..........................####.....########...#
##.........##..####............#####...................................###########..........####............##......#########.##
###......#########.............#####....................................############.......######..................#####..######
####....#####..##..............######..........................##........###...######......#########..............######..######
####....####...................######..........................#.........###....#####.......#########............#######...#####
###.....####..................########...........##..........##.........#####................########....##......#######....####
###.....#####................###############....####........###........######................#######....####......#####......###
###.....########.............#################..#####.......####.......######................######.....####.......####......###
###.....#########............########################........###........####...............#######.......##.........##.......###
###.....##########..........##########################........#....................###....########............................##
###......########...........########...####..##########............................###....#######..............................#
###........##................######.....##....#########............................##......######..............................#
####...........................................########.............##......................#####..............................#
####................#####.......................######.............####.....................#####..........##....###..........##
###................#######.......................####...##........#####..........##.......#######..........###..#####........###
##................########.......................####..####.......#####.........####......#######...##.....##########........###
##...............#########.......................####..#####......####..........####......######...####....#########.........###
##.............####...#####...............###....#####..####.....####...........#####......####....#####..#####..............###
###...........####.....#####..............###....#####...###....#####............#####............############..............####
####.........#####......#####.............##.....####....###....######.............###............###########............#######
####.........#####.......####............###.....####....####....#####..............###..........##########..............#######
###...........#####.......##............####.....####....####.......................###..........####.####...............#######
##.............####.....................#####.....###....####........................##.........####...##.................######
##....###.......####..............#.....######....###.....##....................................####...##..................#####
###..#####.......###..........######....######...####............................................##...###...................####
##########.................########.....#####...#####.................................................####......###..........###
#########.................######........####...######............................##....................###....######.........###
####......................#####..........###...######...........................#####...................#....#######.........###
###........................####...........########..............................######....##................#######.........####
###.........................###............######......##........................############..............#######.........#####
###...........................##.....#......#####......###.......................############......###....####.E............####
###........##..................##....##......#####.....##.......................############......###########.................##
###........##..................###...#.......######..............####...........###########........##########..................#
####...........................####...........####..............######..........###########.........#########..................#
####...........###.............####..................#..........######...........##########...........######..................##
#####.........#####.............##..................###....####..####............##########............#####..................##
######.......######..................................###########..##.............##########............####...................##
#######.......#####..........................###.......#########................##########...##.........###........###.........#
########.......##........##.................#####...........####................#######......##..........##..###..####.........#
#########...............####................#####............###.........##.....######.......###...........##########.........##
#########...............####...............#####..............###.......####....#####........###...........#######.......#....##
#########...............####..............#####...............#######..#####.....###..........#............######.......###...##
###..###................####.............######......##.......##############........................##....######......####...###
##.......................##.............########.....##......##############........................####...######.....####....###
##........###......#...................#########...........###############........................#####...######......###....###
##.......#####....###.................##########..........###########.............................###############......#.....###
##.......#####....####.................########...........####...................................#################............##
##.......#####.....###....................................###..................................###################.............#
##.......#####.....###....##..............................##..................................######.############..............#
##.......######...###.....##..............##..............##..................................#####...#####..###..............##
##......############.....................####.............###...........##.....................###....####...................###
#......############............###.......####..............######......####.....##.............###....####..................####
#......##......####...........#####......####..............########...######...######..........####...####.................#####
##..............###...........#####.....#####.......##......###############....######.........#####....##..................#####
##..............###............####.....####.......###.......############.......##...........#####..........................####
#................#.............####......###.......###.......####...#####...................######...........................###
#...............................####......#.........#........###.....####...................######...........................###
##....###.......................####.........................##.......######.................#######.........................###
##########......................####.........................##.......######..................##########.........#............##
##########.............###......####.........................##.......######.....##............##########.......###...........##
#########..............###.......###............######........##.......#####....###..................#####.......#............##
######.................###........#............###########.....####.....#####...###........###......#####.....................##
#####.................#####....................###########......####.....####...##........#####...............................##
#####.............############.....................##............####.....###.............#####...............................##
######...........##############...................................###.....###.............#####...............................##
#########.......##############....................................###......###............######.............................###
##########....#####..#####.............#...................................###...........########............................###
#################.....###.............###.......................................##....#######..#..............................##
###############................###.....##............###.......#..............#####..#######...........##.....................##
##############..............#######....########......###......###............##############...........####....................##
##############.............#########..#########......####....####...........###############.........#######...###########....###
###############......###..######################....##############...###..##################.....###############################
################################################################################################################################
