################################################################################################################################
###......................................................................................................................#.#.###
###............############.###....###########.############.####...####................##########################............###
###............##....####...........##########...##########.###...###....................#########.######..######..............#
###....................#.............########.......#.#.....#####.###....................#######......#......####.............##
##...................#.#..............########...............#######.......................######............####.............##
##...................#................#######.................#####........................#####...............##.##.........###
##..................###................######.................##............................####..................####......####
##.................####................####............##.....##..............................#.................#.####.....#####
###.................###..###...........####............##.....##................##.##..........................##.#####...######
###................#########...........###.............##.....##...........#######.#...........................##.#####.....####
###.................########............####...........##....###..........########.#...........................##.######......##
###................#######..............####...........##.....##..........########.............................##.######.......#
###...............######.................####..........##....###.........#####...........................##.....#.######.......#
###..............#####.....................#..................##.........#####...........................#......#...#####......#
###.............######......................##.........................#####............................##...........#####.....#
###.............####..........................................#.......######...................###.....................###.....#
###.............###..........................##...............#......######....................###.......................#....##
##...........................................##..............####......###.....................#####.....................#....##
#.......................###..................###.............######.................##..........####.....................###.###
#........................###.................###..............######................##.........######...................########
#........................####.................##..............#####............................######...........#......#########
#.........................###.................##................#...............#...........######.#............#.....##########
#..................##.....###.................##...............................##.........########.............##.....##########
#................####.....###.................###.......................................########................#.....##########
###..............##.#....####................####......##...........#.................##########...........#...##......#########
###.............###.......###...............#####.....####.......#####..............###########..........#####..#.......########
###...S.........#...........................####.......###......######.............#####..#####...........#######.......########
###..#.........##......................................##......######..............####....###...........#######.........#######
###..#.##.#....##....................#.........................###.................#####...#.............#######.........#######
#....#.####....#.....................###......................###..................#######................######........########
##...#.###....###.......................##....................##...................#########...............######.......########
##.#.#.###.....##.............................................#....................#########.................####......#########
####.#.##.....####...............................................................#.###########................###.......########
####.#.##.....#####................................###...........................#.############.....###.........#.........######
####.#.##....#######................................##..........................##.####...#####...######.....................###
####.#.##....#########...........................................................#.#####.##############......................###
####.#.##....#########...........................................................#.####...###########.........................##
####.#.##....#.#########.....................................................#...#.###....#########..........................###
####.#.#.......#########.....................................................#...#.###.....########...........................##
####.#..........########...............................#....................######.#.......#######......................#.....##
###.............######...............................####...................###.##.#........####.#...........#........####.....#
###.............######...............................###....................###............#####............###.......#####....#
##...............#####..............................###.....................##..............#####...........###.......####.....#
##..............#######.............................####....................###............###.##............##........##......#
###....####......########...........................###......................#.............#...##..............................#
###......##.....##########..........................###.....................####.........####..........#.......................#
####.#...........#######.#.#.........................##...........###........###..........##...........##.....................##
####.#..........########..###....................................#######....######......................##....................##
####.#..........#######....##...............##...................#######....######......................##...................###
####.............######.............#......###..................########.....#####.......................###.......######.....##
####............#######............###......###..................######......#####.......................###......########....##
####.............#####..............#.......###...................#####.......####........................####....#######......#
####............######............................................#####........###........................####.....#######....##
####.............###.....................................##........####.........##.........................###.....#######....##
####.....................................................##.......######........##.................................#.###########
###......................................................##.....########...................##......................#.#.#########
###.......................................#..............##.....#######.........##..........##......###...........##.....##.####
##........................................##.............##..###########........##..........##.......####......##.##..........##
##..........................................................############.......###...........##.........#......##.###..........#
##...........................................................###...#######..#.#.##..........####........#.....###..............#
#...............................................#..................#####.###.....#.#........#####..............................#
###....##......................................##...................##.............#........######.......#.....................#
###..#.#######................................###..................##..............###......#######.....###...................##
####.#.#####..................................##..................###..............####......####......####...................##
####.#.#####....########....###..............###.................###...............#####.......#.......######.....#...........##
####.#.####......########...###.###..........#..................####.........#####.####................#######.##.###.........##
####.#.#####......#######....##.####......................#.########..........####.#####.................#####..#.###.........##
####...#####......########...##.#####...#................##.#########.........####.###......#.#......#..#####...#.####.......###
###.....#####.......#.#.........#####..####..............##.#########..........###.###....#####.....##..####....#.###.......####
##........#...................#.##########..................##########.........###.##....#######....#########...#.###.....######
##............................#.###....###........##........##########..........##.##......####.....#######...###.#........#####
#...........................###.###....#..........###.......##########..........##.##......######....############.#..........###
##.......................######.##...............####.......####...###.............##........####.....#####.#####..............#
#.......................#######.##..............######......####.............##....##........######...#####...###..............#
##..............#........######.#..............########.....###..............##....###.........#####...#####...................#
##.............###............#.###..........###########....###.............##.....###.........#####....####...................#
###.....#......###................###........############....#..............###.....###.......#####......###............##.....#
##.....####.....##.........................##############...................##.....####.......#####........#............###....#
###....#####..........................#.#.###############.................#####.....###.....######.........#...........###.....#
##.....#####...........................###################................####.....####.....#######....................#......##
##.....#####...........................############....##................###........###.......#####............................#
##.....#####...........................####.######........................##.......####.........####..............##..........##
#.......####............................#....#####.......................##........#####........####............#.##...........#
##......####..................................#####...........##..........##............#.........####..........#.#...........##
#.........##...................................#####.........###.........##.............##....#.########.......##.#...........##
###.......#....................................#######.......#####.......##.............###..###..#######......##.............##
####.............................................######......######.....##..............###.........#####......##...........####
####..............................................######....######......................###..........####......##...........####
####........................#....##.................#######.######......................##...........###......###..........#####
###........................####.####................#######.####....................................####.......##...........####
#..........................####.####.................######.##.......................................###.....###............####
##...........................##.####................#######...........................................#.#.#.#####...........####
#................................###..............#.######................................................#######...........####
##...............................##............###########.................................................######..........#####
#.............................................##########.....................................................####.........######
##.......................#....................#########................###....................................###........#######
#.........#....................................######..................###.............###.....###.....................#########
##.......##........................................................########............#####.#.####.................############
##......####.................................................###.########..............############................#############
#.......######..............................................############...............############......#.........#############
##.....#########................................#...........###########.................######.####......##........#############
#......########................................####.........##########...................#####...#..................############
#......#.#######............###.................#####.....#.##########...................###..........................##########
#........######...##........###.................###########.#########...................................................###..###
#.........#######.###.......###...................#########.#########..............................................E....#......#
#........####.#######.......###......#............#########.########...........................................................#
#...............######......##......####............#######.#########......####....................................##.#.##.....#
##..............######.............####.............#######.#########.....#######.............##...................##.#####....#
##................#####...........#####.............#######.###########.....####..............##......................####.....#
###.......#.......####...........#####..............#######.#.##.#.#######....##..............##........................#......#
##........##.......##............#####........#.....####.............####......................................................#
####....######....................#####.......###.######.............####..................................#...................#
####...########...................######........######...............####......#.........................####..................#
####...########..................########........######..............####....#####........####..........#######....##..........#
####...#######................#.###########........####.....####....######..######......#####...........#########.###..........#
###....######................##.############........#####.#.####...###############.###########.........##########.###....#.....#
####.#.######................##.#....########........#############..##############.##########.........###########.###..####....#
##...#.######.#............####......########.........###############.#.##########...#########.......############.####...####.##
##.###.########..........####.........######..........##.#.#######..........#####.....########.......#########....####....######
#....#.#######..........#####........###......................###...........#####.....########.#.....######.##.....###......####
######..######..........#.#..........#.......................................####....#########.###....###........###........####
###.....######..........#........#.####.....................................#####...##########.##.....###.....#.####..........##
##############.........####....########...........#.........................##################..#.....###.....#####...........##
################......#####.#.##########.........####......................###################....#.######....#######.........##
################.....####################.......#########.#.########......####################..##########....########.#.....###
##################.#######################....########################...#####################.#############.###################
################################################################################################################################
