################################################################################################################################
###.#.#.##################.##############################################.##################........############################
###.....#####.......######...###.........#####################.#.#.#.#......#######....####.........#########......#############
#........###.........###..................###################................######.....###..........###.#..........############
##.......##..........###...................##################.................###........##..........###............############
#........#...........###...................#############.###...................##.........##.........##.............#######...##
##..................###...................############.....###............................####.#.....#..............#######....#
##..................###...................########.###....................................########..................######.....#
###..................#..................########.............................#............#######....................#####.....#
###.....................................########...........................####..........######........................##......#
###.........................................###...........................######........#####..................................#
####.......................................................................####.......####....................................##
####.........................................................................#........####.....................................#
####...................................................................................##.....................................##
###.........#.................................................................................................................##
###........##.................................................................................................................##
#....................###..........................................................................####.......................###
#...................###...............###........................................................#####.....#.................###
#...................###...............####.................................#......................######.####................###
#..................####...............####.....................#..........###.....................############................##
#...................##..................###......#............#######.....###......................############...............##
#................................................##...........#########....##......................############...............##
#.......###......................................###............######.......S.....................#############..............##
#......###....................###.................................###.............................##############...............#
#.......###.................######................................................................##############..............##
##..........................#####.................................................................########.####................#
##........##................#####........................................##..........................###...####...............##
##.........###........#.....#.##.........................................###................................##.................#
###.......####.......####...............................................####......###...............................###......###
##.......#####.......#####...............................................###......##..................................###.######
##.......####..........###................................................#........##................................##.########
#......#####...........####........................................................##......................................#####
#......#####.............##....................###............#.....................##.....................................#####
#....######.............####...................#####.........###....................#.#......................................###
##...######.............###...................#######........###.........................................###........###......###
##...####..............#####..................#######.......#####...............................#......#####.........##.......##
###..####..............#####...................#####.........###...............................###....####.#.........###......##
####..#...............#######....................#...........###............#.................###....####.............##......##
#######..............########..............................................#####.#.#........#####.....#...............###......#
#######..............#######................................................##########......####.......................##......#
#############.......#########..............................................############....#####.......................###.....#
##############......########.........................#......................##########.....####................................#
#########...####...###########....##................###...............###.#.##########....####...............##................#
#########.....##.#####....####.....#................####.............########.#.#.##......####...............##................#
########........#####.....####......................####..............######.......#.#.....##...............###................#
#########........####.......#........................####............######..........#.....##................#.................#
########..........####................................###.............#####.........###........................................#
####...............####..............................###.............####............#.........................................#
###................######............................###............#####......................................................#
##.............#...#.#####..........................##.............#####.......................................................#
##............##...#.#.####.........................##............######.......................................................#
##.............#...#.....#.........................##..............#####.......................................................#
###...##...........#...............................##..............######................###...................................#
###...###..........#..............................###..............######...............###....................................#
#########.........###...........................#####..............#####.......................................................#
########..........###............##.#.........######.............#####...........................................##............#
########.........####.............####........######.............####.............###...........#.#.#.#..........###...........#
##..###..........###................##.........###...............###............#.##..........###########........####..........#
#.....##......................................................................######.........############..........####........#
#............................................................................#####..........##############.........####.......##
#.......##....................#...............................................#..............############...........###.......##
#.......###..................###............................................................#########.##...........#####.....###
#.......####..................##.............................................................######.................####.....###
#........###................###.............................................................######..................#####...####
#........##.................###.............................................................####....................#####....###
#...........................#..............................................................#####.....#.....###......####.....###
#.................................................................#.#......................###......####.#.####.....####......##
##................................................................####.....................####.....##########......####......##
###.#.............................................................####......................##......#########.......###.......##
#######...........................................................#.#................................########.......###.......##
#######..............................................................................................#######.........#........##
########...............................................................................................#####..................##
#######........................................................................####....................#####..................##
####.#..........................................................................#####....................###..................##
##..............................................................................######...................####..........###....##
##...............................................................................######..................####.........####..####
##........#................................................................#.....######..................#####........##########
##......####..............................................................###.....#####...................#####.......##########
##.....####...............#.................##............................###....#####.....................#####.......#########
##.....####.............###.................###............................##.....###........................###.......#########
##....###.............#.##...................##..................................###....................................#####.##
##.....###............#####.................####.................................#......................................###...##
##...................##...#......................................................#.............................................#
##....................##............................................#........#.................................................#
##....................##..............................##............##......####...............................................#
##.....................###............................##.............#......###................................................#
#......................####...........................###...................#####..............................................#
##......................###..............##...........###....................####..............................................#
#........................###............#####.........####...................######................#...........................#
##.......................###.............######.......####...................#####.............#...####........................#
#........................###...............######....######...................###.#.........####....####.......................#
##.......................###..............#########.########...............................####.....###.......................##
#.........................##...............##################......................###.....###......###.......................##
##........................................##################...............................###......##........................##
##........................................################..................................##......##........................##
####.#...................................#############.#...................................###................................##
#######..................##..............#######...........................................###................................##
#######.................###.............########...........................................###................................##
######..................##..............########.........................................######...............................##
#######.................................###.#.#..........................................######.............................####
#######.................................................................................#######.............................####
#######........................................................................##.......######.........###...........###...#####
#######.......................................................................####.......####........E####...........###########
#######.......................................................................#####................................#############
#######.#..................................................................##.#####................................#############
#######.#.............#..................................................#########................................##############
#######.##...........####..............................................##########.................................####..########
###...................#####............................................#########...............#...................#.....#######
###.....................#####.........................................#########...............####........................######
##......................######..............................##........#####.#................#####........................######
##.......................#####...............##............###........#####.................#######.......................######
###........................####.............###.............#...........#...................######........................######
####.........................##.............####...........###..............................######........................######
####........................................###.............#...............................####..........................######
####........................................###............###..............................####................###.......######
####........................................###............###.............................####................#####......######
######......#...............................##.............###...........................####..................####........#####
######.....##............##.................................#..........................####...................#####........#####
######.....##...........###................................##..................#.......##.....................####.........#####
######.................####...................................................###..............................####........#####
######.................######................................................####..............................####........#####
######.......#........##########..................###.......................####................................#####.......####
######.......#.........##########................####......................#####................................#####.......####
######.......###......###########................######....................####.................................#######......###
######.......####......###########..............#######.............#....######................................##########...####
######.......#####...#############.#.#...........########........#######.#######...............##..........##############.#.####
########.#.#############################.#.#.#.##########.#.#.##################.#.#############################################
################################################################################################################################
