################################################################################################################################
################..##....###......######.....######..############################################################################
###############....................###...................#########..........##############..##.#####...##########..#######..####
#####......####..........................................#######............#############.......###........#####....#####....###
####........###..........................................#####..............#############.......###.........####....#####....###
####.........##..............##.........................####.....##........##############.......####........###......#####...###
###..........###............###.........................###....#####.......#######...###........####.......####.......#####..###
##......##..####.........#####.....##...................###...#######......######..............####.......#####........####...##
##......########........######....####..###............###....#######......######.............###........######........####...##
#.......########........######....#########............##.....######........#####.............##.........#####........####....##
#.........######.........#####.....########............##......####..........###.........................####........#####....##
#..........####...........###........#####.....................###.......................................####......########...##
#.....................................###......................###........................#..............####.....#########...##
##............................................................####.......................###.............####....#####..##....##
##.............................S..............................#####.......................#..............###....#####.........##
##........#..................................................#######.....................................###....#####.........##
##.......###................................................########.....................................###.....######.......##
###......###................................................#########..........##.......................####.....#######......##
####.....###.................................................############.....#####....................####......#######......##
####....####.........................###...........##.........###########......#####.................#####.......#######......##
####....####.........................###..........####..........#########......#####.......###......#####........######......###
###......####..............###.......###..........####............####.........#####......#####.....####........#####.......####
###.......########.......#####......###...........####.............##..........######....######......##.........####.......#####
###........########.....######.....####...........#####.........................######...######.................####.......#####
###........########....###.........####..........########......................########...#####.................####.......#####
###........########....##..........###...........#########..................###########....####.................#####.......####
##.........########....##.......................##########.................#############....####.................####........###
##.........#########..####.....................#####..###.................######..######....####...###...........####.........##
##........#################....................####.....................#######.....###....######.#####..........###..........##
##..##...##################.........##.........####...................#########..........#################......###..........###
##..##...#######...#####...........####........###...................#########..........#####################..####E........####
#...##...####......................####.......####...................########..........########..###################......######
#...########.......................#####......####..................######.........##########.....###########..######....#######
##..########......................#########....##..............##########.........#######.........##########....######...#######
##..#######......................###########..................###########.........######..........#########......#####...#######
##..######...........#######....############.................###########.........#######.........##########.......###....#######
##..#####...........#########...####..#####..................##########..........######.....#...###########...............######
##..#####...........#########...###....####....##............#########............###......################................#####
##...###.......##..##########...........####..####...........#########.....................#########...###.................#####
##............###############............########............#########......................#######........................#####
###............##############.............#####..............#########.......................#######......................######
#####.............###########.............####...............#########........................######.....................#######
########...........#########..............###.................#########.......................######....................########
#########..........######................###...................########....######.............######....................########
##########........######................###.....................######....########.............######...................########
#########.........######...............####.........###.........####......########.............########...................######
######.............####..........###..####.........#####........###........######.............#########.........##.........#####
###.............................#########..........#####....##.####.........####...##..........##...###.........###.........####
##..............................########..........#####....########...............####..........................#####........###
##.........................###...#####............###......########...............#####..........................####.........##
##.......................######...###......#.....###.......########...............######...........................##.........##
###.....................#######...###.....###....###.......########..............########.....................................##
###.....................#######....###...####.....###.......#######.............##########....................................##
##......................########...##########......###.......######.............###########.....................#.............##
##......................########....########.......####......######..............##########.........###........####...........##
###......................####.###....######........####.......#####.................######..........####.......#####.........###
####.......##............###...##....####...........##..........####.................#####...........###.......#####........####
#####.....####...........###..###.....##.........................####................#####......#....###........###........#####
######....####...........###.####.................................####...............#####......##..###....###.............#####
#######..#####..........###..####.................................####...###....##..######.......######....####............#####
#############..........####..####..................#..............####...###...##########.........######..#####.............####
############.....#.....#####..###.................###.............####....##....########...........###########................##
##...###........###....#####..........###........####.............####............#####............##########..................#
##..............####..#####..........#####.......####............#####.............###..............#######..............#.....#
##...............#########..........######........##............######...............................####...............###....#
###.........##....########..........#####......................#######..........................#.......................##.....#
###........####.......#####.........#####.....................#######..........................##.......................##.....#
###.......#####........########.....####......................#######.#.........................#..............................#
##........#####........########.....####......................####....###..........................................##.........##
##........#####.......#########......##........................##....####........#....................####........####........##
###........###.......#########.........................##...........####........###..................######........###........##
######..............#########.........................###...........####.......####.................#######........####.......##
#######.............#########..........................##..........#####.......####.................########........####......##
#######.............##########..................##................######........####......##........#########.......#####.....##
######.............#############..............#####...............######........####....#####........##.#####.......#####....###
#####.............###############............######................####.........###....######............#####......####.....###
#####.............##############............#######.................##.........###....########............##.#.......##......###
####...............########.............###########.......###..............#######....#########..............##..............###
###........##...........##.............#############......####............#######....##########...............##............####
##.........##..........................#############......####...........#######...####..#####................##............####
##........###..........................#############......#####..........######...#####..####.................##............####
###.......##.................##.........############.......####...........###.....####...###..................###............###
####......##................#######......##########........###...........................##...................###.....###....###
#####.....##................########.......#######.........###...........................##...................####...####.....##
#####.....##.................#######.........#####.........####..............................................#####...####.....##
####.....###...................######.........####....##....####............................................#####....###......##
####....####.....................#####.........##....####....####..........................................#####......#.......##
############......................######............#####.....#####............##.........................######.............###
###########........................######...........#####.......####..........####.......................#######............####
########............................######.........#####.........##.....###..######......###............#######.............####
#######....................#.........######.......#####.................############....#####...........#####......###.......###
#######...................###.........################...##..............###########...########...##.....###......#####......###
########................####.............#############..#####.............########....###############............######.......##
########...............#####..............###########...######.............#####.....################...........#######.......##
#######................#####...............####...##.....######..............##......###########...............########.......##
######.................#####...............................###........................#########...............#########.......##
####...................####.........##..............................#..................######................##########.......##
###...................####.........####............................###...................###...............############...##..##
###..................#####........#####...........................###...............................#############..###....##..##
##..................######........####...........##......###.....###................................########..............##..##
##...................####.........###...........####....#####.....#....................................####...................##
##.....###............###....#....###..........######...####...........................................####...................##
##....####.............##...###...###..........#######...##..................##........................#####.........##.......##
###...#####............##...###....##.........########......................####..........###.........######........####.....###
####.#######............##..###....###.........##..##........................##...........####.......#######........####.....###
############............###.###....####...................................................####.......######.........####.....###
#############...........###..###..#####..................................................#####........#####..........##.......##
##############...#......##....#########.................................................######........####....................##
##############..###.....##....########.................................................###..###.......###......###...........###
#############...........##.....######.................................................###....#.........##......###...........###
##.########.............###.....#####........................................#........###..............###.....###...........###
#...######...............##......####............................##..##.....##........####..............###...................##
##...###.................##.......###..................##........#######..............####..............###...................##
##......................###.......###.........###......##......#.##..####............#####.............###....................##
##.....................####........#..........####.....##.....##.#.....###..........#####....##......####....................###
##............###.....####....................######..........##.#......##.........#####....####....####.....................###
###...........####..#.###.....................#######..........#........##..........####...#####...#####.....................###
#####..........######.##......................#######...................##...........###..######...#####..............#......###
######..........#####.##......................######.....###...........###..............#######....#####.............###......##
######....##....#####.##........#............######.....#####..........###..............#######.....####..............#.......##
######...###....#####.##.......###.........#######......#####..........###..............#######......###......................##
#####....###....#####.##.......#####...##########.......####..........####..............########.....###......................##
###......####..######.#........######...#####...........####..........####...............##..####...###.......................##
##.......#########................####..####.........#...####.........####...................####...###......................###
##......#########.......##.........###...###.......####...######.....######.....##...........##########..............###..######
##.....###########.....####........###...####..#########...#######..########...####.........############............############
###...###############.#########...#####.#################.####################################################....##############
################################################################################################################################
