################################################################################################################################
####..........................................................................................................................##
####.............###................########................########........................#####........#########......#####.##
###..............###................######....................###.............................#...........########......#####.##
###...........................S.......####...................####.........................................########.......####.##
####..................................##...................................................................#######........#...##
####...................................#......................................................................####.............#
#####.........###...............................................................................................###............#
####..........##...............................................................................................###.............#
####.........###...............................................................................................####............#
####.........#...............................................................................................#####.............#
###...................................................................................................##.....######...........##
###..................................................................................................####.....#.#####.#.......##
###.....................................................###................##........................###.........######.......##
###.....................................................###..............######...................................#####.......##
###.....................................................###..............######.............#......................####.......##
###........................................###...........#.............#########............##.......................#........##
###............................###........####.........................#########..............................................##
##..............................###......................................#######............###........................###....##
##..............................###.........................................#####............###......................#######.##
#................................###........................................................####................#.#.#########.##
##...............................###.........................................................##...............###############.##
#.................................##................#.......................................................#######.#########.##
#...................................................##......................................................#####.....####.#..##
#..................................#................#.........................................................#...............##
#.................................#...........................................................................................##
##................................##...........................................................................................#
##...............................###................................................................##........................##
###..............................####..............................................................###...............#.........#
##..............................####......................#.###....................................####............####.......##
##..............................####...................#########...................................###........................##
#..................#...........######.................#########....................................#####......................##
#...........................########.................########.#.............##......................####...................##.##
#..........................#####.#...................######.................#.......................#####...................#.##
#.........................#####.....................#######................###........................####................###.##
#.........................####.....................#######..............................................###...............#...##
#........................####.....................########.....####......................................####..................#
#.....................######......................########......##........................................###..................#
#...................#######..............##.......########.....###.................................##.....####.................#
#.................########..............####.......#######......#..................................##....#####.................#
##..............#####.#.................###........#######.....##.......................................######.................#
#..............######................................####......#........................................######.............#.###
#.............#####..................................###................................................######............######
#...........########..................................#.................................................######............######
#.......#...#######......................................................................................#####............######
#.....#####..######......................................................................................#####.............#####
#.....###.....######......................................................................................####............######
#....####.....#####....................................................................#.#####.............###............######
#....###......######...................................................................######................#............######
#....####.....######.#..................................##...............................#.............................####..###
##.#####......#########..................................##.............................................................##...###
#########.....########...................................##...................................................................##
#########......#######....................................###.................................................................##
########.......######.............###.....................#####................................................................#
#####...........#####............#####.....................######.............................................................##
###.............######...........#####......................#######...........................................................##
###.............#######...........#####......................######..................###.....##...............................##
###.............########..........####.......................######.................#####...#####.............................##
###.............###.#####.........#####......................##.#...................######.#####...................E..........##
###.............###....###........#####......................##.....................###......#.................................#
##.............###...............#####........................................................................................##
##............................#.######.........................................................................................#
#..............................#####..........................................................................................##
#................................#...........................................#.###.............................................#
#.................................................###......................#######............................................##
#............................................####.######...................#####...............................................#
#..........................................######.#######..................#####..............................................##
##.........................................######.########...................#................................................##
##........................................#######.########....................................................................##
###.......................................#######.#########...................................................................##
###.......................................#######.########...............##...................................................##
####......................................#######.##....###.............####..................................................##
#####.....................................###...#.#......................##....................................................#
######....................................###...#...............###............................................................#
######.........................................................#####...........................................................#
######........................................................######.....................#.....................................#
#####...........................................................#.......................###....................................#
####....................................................................................###....................................#
###...................................####..............................................###......##............................#
###.................................########............................................##.......##............................#
##..........#.......................##########.........................................##.......####.........................###
###........#####.....................#######.....................###.#................###.......####.........................###
##.........####.........................##......................######................###.......####.........................###
###..........#..........................#......................######...............#####.......####..........................##
##.............................................................####................######........##...........................##
###..........................................................#####................#######......................................#
###....................................................###...###...................######.....................................##
####...................................................#######.......................###...............##.....................##
###.................##................................######...........#...............................###.....................#
####...............###................................######..........####.............................###....................##
###...................................................#####...........####..............................##.....................#
#####.................##..............................#####..........####................................#....................##
#######...............##...............................###......##.#.####....................................................###
#######...............####.............................###.....#########....................................................####
#######................###.....................................#########....................................................####
#####....................###....................................#######.....................................................####
####....................####....................................#######.....................................................####
##.......................#####.#.####.#..........................#.##.........................................................##
###......................###################..................................................................................##
##........................####################.................................................................................#
##...........................###################..............##..............................................................##
#............................####################............####...####.......................................................#
##.............................############.#.###...........####...######.....................................................##
#..............................############.....#..........###.....#####.......................................................#
##.............................##########..................#.........##......................................................###
#.............................##########..................................................................................######
##............................#########......................................................................###........########
#............................#########......................................................................####.......#########
##..........................##########.......................................................................##........#########
##...........................####.#.##........................................................................#........#########
###..........................####....###................................................................................########
####..........................##.......#............................................................##......#.#.#.......########
####...........................#.......##......................#...................................###......#######.......#.####
####..........................................................###..................................#.......#########..........##
###..............................#...........................####....................###...................#########..........##
##...............................#................#............#.....................###...................#########...........#
#......................##........##...............##................................#####....................#####............##
#.......................#.......................#.###.........................#.....#####......................#...............#
#.......................##......................#.####......###.......##......###...#####.....................................##
#.......................###.....................#.############.......###......###.#.#.#........................................#
#.......................####..............#.#.###.#############......###......#####..........................................###
#........#..............#####.............#######.....##########...#####.......#####.........................................###
#.......###.............######............######.............###########......######.......................................#####
#.......###............########.............####.............###########.......#######...........#.......................#######
#.....#######..........##########..........#####..............###########....#########..........####.....................#######
###.#.#######........############..........######...........###############.############.#.#.#.#######.................#########
###############.#.###################################.#.#.#.##############################################...........###########
################################################################################################################################
