################################################################################################################################
#######################..............................................................................................###########
######............####..........................###############....#################....######............#######.....##########
#####............................................##########.........#############.......#####..............######......#########
###..............................................#########............########.........#####...............######............###
##..............................................###########............#####...........####...............######.............###
##..............................................###########.............###.............###............##.#####..............###
##........................##.....................##########..............................#............###.##..................##
##.......#...............####.......................#######........#..................................###.#...................##
##.......##..............####...........#............######.......###.................................###.....................##
##.......#...............#####.........###...........#######.....####................................####.....................##
##......................#######........###...........#########...###.................................####.....................##
##.....................#########......#####..........##########...#.........##......................#####.....................##
##.....................####.####.....#######.............######............####....................######.....................##
###..###................##...###....########..............####.............####....................####............########..###
#########....................###.....########.............####.............###......#####..........####...........##############
#########....................###......#######.............####..............##.....#######.........###............##############
########.....................####........###..............####......................######.........##..............#############
#######.......................##..........................###........................####...##....###.....##.......#############
###..........####........................................................##...........##...####..#####....##......##############
##..........#########................................................#######...............####..########.##.....###############
##..........#########..................####.........................#########.............####....#######.######################
##.........##########..................#####.......................##########.............####........###.######################
##........###########...................####..................###############..###.........##..........##.########...###########
##.......############....................###.................#########..####...###.....#...............##.#######....###########
#.........############...................##.................#########....##...####....###..............##.######.....###########
#..........######..##...................###.................#########........####..................#..###.#####......###########
##..........####.........................#...........#.......########.......####..................#######.#..........######..###
###..........###....................................###..........####.......###...................#######.............####....##
###..........####...............................########..........###.............................#######..............##.....##
###...........##................................########..........####............................#######.#...................##
###...............................##............########..........########.......................########.####................##
######...........................#####...........#######...........#########..##....####........#########.#####...............##
#######..........................######...........######............#############..##########...#########...####..............##
######............##..............#####............######............###########..###########....#######.....####..............#
####.............###.................#......###....######............###########..##########.....#######......####.............#
###.............###.......##...............#####...######.............#########...######.........########.....####.............#
##............####.......####.............######......................###..###.....####.........###########...####............##
#............#####.......####............######.......................##.....................#####################...........###
#............######......###.............#####........................##...................######################...........####
##...........#######.....................####...................##....###.................############...#######.............###
##...........#######......................##...................####....#########.........#####.....##.....#####..............###
##..........########...........................................####....###########.....######...............###........##....###
##.........########.............................##....##......#####....#####################.................#.......#####...###
##........#######..............................##########.....####....####..###############.........................#######..###
##........######.......###....................############.....##.....###........#########...........................##...#.####
##........#####.........#.....................#############........................#######................................######
###...S...#####..............................###############........................######...........##....................#####
######....######............................###.....###########.....................#######..##.....####....................####
#######....#########..............######....###.........########..###................###########....#####..........#.........###
########...##########............#######....###..........#############..................#######....######.........###.........##
#########..###########..............###......#............#############..................#####.....#####.........####.........##
######################.........######.......................############.......##.........###......####..........####.........##
#####################....##....###...........................###########......####........###.......##............##......######
##############..........####..###............................##########......#####........####...........................#######
#####...#####..........##########..................###........##....##.......####.........####...........................#######
####.....####..........##########..................####...................................###...........................########
####.....####.....##....#########..................####....................................#.........##...............##########
###......####....####........###...................#####...........................................#####....###......###########
###.......##.....#####.............................######............####......###..............#########..####......###########
###..............##########.................##.....#######..........#####.....####.............################..........#######
###.............############...............###......######..........#####.....####.............###############............######
###..........###############...............###.......#####.........####.......########.........###...#########............######
###.........################...............###.........####..##....###.......##########.........#.....########............######
###..........#######.......................####........#########..###.......############..............########............######
####...........####.......................#####........##############......##############............#########.............#####
#####..................###...............######........#############.......########..#####..........#########................###
#####.................####...............#######........##..########........#####......####.........#######...................##
#####..................###...............#########..............###..........###........####........#######.....##............##
#####.......................................#######......................................###........#######.....###..........###
#####........................................######..............................#.......###........#######.....######......####
#####.........................................#####.............................##.......###........###..##........####....#####
####..............................###..........####..........##.....######.......#......###.........##..............###...######
###..............................#####....##....####........####....######.............####.........##...............#....######
###.......................#......######..###....####........###.....#####.............#####...............................######
###..#...................###.....###########....#####.......##........................#####...............................######
#######.................####.....##########....######.................................######.............................#######
######...................##......#########....######..................................######.............................#######
######.......................########.........######...................................####.....##.......................###..##
#######......................#######......#..#######...........................................####...........................##
########.............##......#######......##########...........................................####...........................##
#########...........####.....#######......##########..........................................####......###...................##
##.....##..........########...######.......########......................................########......######.................##
#.................##########...####.........######......................................#########......#######................##
#................###########................######.....................................##########......########...............##
##...........###############.................######...................................####..#####......########...............##
##..........################...................#####.............###........##.....#####.....#####.....#######................##
##...........###...##########....................##.......###..######......####...#####......#####.....######.................##
###.................#########....##...###................############......####...####.......####......######...###..........###
###.................########....###..#####..............############.......###....####.......####.......######.#####..####...###
###................######......####..#####..............###########........##.....###.........##........##################...###
###...............######......############....##.........#########................##....................##################....##
##...............#######......###########....####.........#######................###...................####..##########.......##
##.............##########......#########.....####................................###...................###........####........##
##............###########.......#######.......##................................#####..................###.........###........##
##.............###....##.....#...#####.................#........................#####..................###.........####.......##
#...........................###....##.................###.......................####...................####........#####......##
#...........................####......................####.......................##....................####........######.....##
##...........................####.....................#####..##.........................................###........#######....##
###...........................###......###...........###########...................................................#######....##
###....................##.....###.....#####.......##############...................................................######.....##
####..................####....####...######......###############...................................................#####......##
#####.................####....####..########....################...................................................#####.......#
######...............####......###..########....###############.....##.....................................#........#####......#
######...............###.......##...########....###############....####...................................###.......######....##
#####................##........##...#######......##############....####...................................###.......######....##
#####................##........###...#####.......##############....###....................................###........#####....##
#####................###.......###...####........###############....##....................................###.........###.....##
######................#.........#.....###.........#####...######....##....................................####...............###
######................................###..........###.....#####....##...................................######..............###
######..............................####...................####....###..........###......................#########...........###
######............................######...................####...####.........#####.....................##########....###....##
######............................######....................##...#####........######..........##.........##########...#####....#
######...........................########........................####.........#####..........####........##########...#####....#
#####.......................##..#########.........................##...........####.........#####.........##########...#####...#
####........................#############.................#.E..................#####........####.............#######....####...#
####...........................###########.....###.......###....................####.........##................#####......#....#
####...........................############...#####.......####...................##..................##.........#####.........##
########......................##############..######.......####..................##.................####.........####.........##
#########.....................#####...######...#####........###.................##.................####..........#####.......###
##########............#........###.....#####....####..................###.....####.................####..........#####.......###
###...#####..........###.................####....##...................####...#####..................##...........#####........##
##.....####.........###...................####........................#############...............................###.........##
#.......##.....#######..............##.....###.........................############...........................................##
#............##########............####....###................##.......#############.........................####............###
#...........############################..#####..............####.....#####################....####.........######......########
##..##################################################..###########################################################....#########
################################################################################################################################
