################################################################################################################################
##################.........................................###################...##########################...###...############
##############.###.####.#.##.#########..#######.............########....#####.....####.....######..#######...........####..#####
#############...##.####.#.##.#######.........................######......###.......##........###....#####............###....####
############....##.####.#.##.######.................##.......#####.................##...............................###......###
###########......#.####.#.##...##................######.......###.................####..........................######........##
##...######......#.####.#.##....................########.........................#####.........................######.........##
##.....###.........####.#.##......####..........########.........................######........................#####..........##
##.................####.#.##.....######..........#######..........................######.........#.............###......#.....##
###................####...##.....######.............####...........###.....##......#####.....S..###...........###......###....##
####........###....###.....#.....#####...............###..........############......####.......####.........#####.....####....##
####........###....####..........#####................###.........############.......##........#####.......#####...######.....##
###......######....####..........#####................###..........##########.................##########..######..######......##
##......######.....####.#........######..............#####.............####..................##################..######......###
##......#####......####.#.......############........######...................................###..#############..######......###
###....#####.......####.#......#############.......#######...................................##....####################......###
############.......####.#......#############.......#######..............##..................###....####################.......##
###########.........###........############.......########......#......######...............###.....##################........##
##########......................##########.......##...###......###.....######.....###......####.....#####..####..####........###
#########.......................##########......##..............##.....#####.....####......####....#####..........##.........###
###...##......##...............##########.......................#.....######.....####......###....#####......................###
##...........####..............########...............####.##...#.#########.......................####.......................###
###.........#####..............#######................####.######.#######.........................####..........####.........###
#####......######...............######................####.############...........................####.........######..##.....##
######.....#######................####...................#.##########.............#######........#####........############....##
######......######.................###........................######....######...#########.......#######......####..######....##
######......######..................##.........................####....###################......#########......##....#####....##
#####.......######........##.##.......................................####################.....#############..........###.....##
#####.......######....#.#.##.###................##...................##############...###......#############..................##
####.......######....##.#.##.###...............###..................##############.............#############..................##
###........######....##.#.##.##.............######..................#############...............###########..................###
##..........#####....##.#.##.##.............#####............###....#############...............##########........###........###
#............#####..###.#.##.###............................#####....#####....###...............#########......#######.......###
#.............####.####.#.##.######...###...................#####.....###......###...............######.......########........##
##............####.####.#.##.#############...................###......###.......###................###.......#########........##
###...........####.####......##..#########...........###...............##.......####.......................############.......##
###..##.......####.##.............#########..........###...............##.......####......................################.....#
##..####......####.................########.........###........................#####......................################.....#
#...#####.....###....................######.........###........................####........................##############......#
##.#######....##....##................######........###.......####.............####...................###.##############......##
###########..####..####....#...........######..########......######............#####..................########.#########.....###
###########..#####.#####..##.####.......###############.....########............#####..................######.....#####......###
##########...#####.######.##.#####.......#############......###..###............######.................#######.....###.......###
#####........#####.######.##.#####........####..######......##....#.............######.................#######.....###.......###
####.........#####.######.##.######..............#####.........................#######.................########.....###.......##
###..........#####.######.##.#######............#######........................######...................#######.....######....##
####........######..#####.#...#######.........############.....................#####......................#####.....#######...##
####......#######....####.#....######........#############.########.............###............####.........###.....############
####....########......###.##....#####.....################.#########...........................#####.........##......###########
###....########........##.###....###.....#################.#########....................#......#####.................###########
##.....######..........##.####...###.....#########...#####...###..#...........###.....####......###..................###########
##......####..........###.####...####....###.........#####..............#....#####...#####...........................###########
##......####....#########.############...##...........###..............###...#############...........................###########
##.....######..##########.############...##...........................###....############....######....###...........###########
###...###################.############..###.......##..................##.....###########....########..####.....###....##########
####.############...#####.##################.....####................###.....##########.....#############.....#####......#######
###.############.....####.####################..#####..........##....####.....#######.......############......#####.......######
##...###########......###......######################.........####....######...#####.........########..........###..........####
##.....#########......###.......####################.........######......####................................................###
##.......###..##......###.......####..##...##.######.........######.......####................................................##
##....................####.....#####...........####.........########......#####....................................###........##
##....................##############............###.........#########.....#####................###..........#.....####........##
##....................###############...........####.......##########.....#####.........###########........###....####........##
##......##.............##############...........####.......#########......#####........############...########.....##.........##
##.....#####...#................#####............###.......#########......#####.......#############..########.................##
##....###########................####.............##.....#.#########.......###........####..######..#########.................##
#.....###########................####....................#.##########.......#........####....#####..#########.................##
#.....####..######...............####...............#....#.###########..............#####.....###...#########................###
#.....###.....########............#####....###......##.....####..######............######............########..............#####
#....####......########.............##########......##.....###....#####.........##########..............####..............######
##...####......#########.............#########......###..#.##.......##.........#####...###...............###.............#######
#########......#########..............####.........#######.#...................####......................###............########
########.......###...##...............###.........########.#....................##.......................###.............##..###
######........................#......##..........#########.##...................##......................####..................##
#####.....................######....##...........#########.####................###.....###..............###...................##
####...###.............#########...###............##....##...######............###....#####.............##.....................#
###...#####...........##########...###........................#######...........###..######....................................#
##...######..........###########....##.........................#######...........#########....................................##
##...#####...........##########.....###.........................#######...####..##########.......##...........................##
#.....###............########.......####.........................######...################......####..........................##
#..............#.....#######........####.........................######....###############.....#####...#####..................##
##............###...########........#####.......................#######.....##############...######...#######.................##
##..........#####...#########........#####....................########......######...#####..######....#######.........###....###
###........######...##########.......########................########.......####......###...######.....######.........##########
####......########...#########.......#########...............#####.........####..............####..........#.........###########
#####....########.....#######........#########...............####.........###.......................................############
#####....####..........######.......#########.................##.........###....####...............................######..#####
#####....####...........####.......#########............................###....######..............................#####....####
####.....####...........###........########.....####..##...............###.....######....................##........#####.....###
###.......###......................#######.....#########................#.......####....................####.....########....###
###.......##........................######.....#########...............................................#####....##########...###
###.......#............................###....#########....................##.......................#########..###########...###
###......##.............................#......#######....................####.....................#######################....##
##......###.............##........................###...................#######....................############..#########.....#
##......###............###.............................................###########............##...####..#####....########.....#
###.....###...........####.......###...................................############..........####...#....#####.....######.....##
####....###..........####.......#####...................................##..######..........#####..#.....#####......##.......###
#####..###..........####.........####.....###................................#####.........#####..###....#####...............###
##########..........###...........##.....#####.............####..............######........####..#####........................##
##########..........###...................####.............######............##########....####..#####........................##
##########..........###....................##..............#######....##......##########....#########.........................##
##########.........####....................................#######...####.........######.....####.............................##
#########.........#####..........................##.........#####....#####..........###.......###.............................##
#########....#....#####.........................####.........##......####.....................................................##
########....##....#####...................##....####.................###................................##...........##.......##
##...........#......###...................###....##..................##........###.....................####.........####......##
#........................##...............##...................................###............##.......#####........#####....###
#.......................####....................................................###.........######......###.........#####...####
##.....................#######...................................................###.......########...................##....####
##.....##########......########.....................#............................###....###########.........................####
##....############......########..................####......................##.........############..............#...........###
##...#############..........#####............##..####......................###.........############.............###..........###
##...##############...........#####.......###########........##.........#####.........##############...........###..........####
##....##.....#######...........#####......###########.......####.......######........################.........###...........####
##............######............####......##########........####.......#####........########..########........##............####
##.............######............###.......#########.......#####......#####.........#######........####......................###
##................####.....##....###........########...###.#####...########.........#######.........####.............#........##
##.................####....##.....#.........##############.######.#########..........#######........#####...........###.......##
##.................####....##...............##############.################...........#######.......#####...........######.....#
##................#####....................###############.#################............######.......###..........########.....#
###..#............######.................#################...###############.............######.................#######.......##
#######..........#######................#################.....#######..#####.............######................#######.......###
#######......E##########...............#################......######....####..............#####...............########.......###
#######......##########...............##################.....#######.....##...............####................#######.......####
########..#############....###........####################..#########...............##########..........###..########......#####
###############################......#################################..........###.#################################.....######
################################....#####################################..##..####.#################################..#########
################################################################################################################################
