################################################################################################################################
################################################################################################################################
################################################################################################################################
################################################################################################################################
################################################################################################################################
################################################################################################################################
################################################################################################################################
################################################################################################################################
################################################################################################################################
################################################################################################################################
################################################################################################################################
################################################################################################################################
################################################################################################################################
################################################################################################################################
################################################################################################################################
################################################################################################################################
################################################################################################################################
################################################################################################################################
################################################################################################################################
################################################################################################################################
################################################################################################################################
################################################################################################################################
################################################################################################################################
################################################################################################################################
################################################################################################################################
################################################################################################################################
################################################################################################################################
################################################################################################################################
################################################################################################################################
################################################################################################################################
################################################################################################################################
################################################################################################################################
###################.#################################################################################.##########################
###################.#############################################################################.........######################
###################.###########################################################################.............####################
###################.##########################################################################...............###################
###################.#########################################################################.................##################
###################.########################################################################...................#################
###################.########################################################################...................#################
###################.#######################################################################.....................################
###################.#######################################################################..............S......################
###################.#######################################################################.............E.......################
###################.#######################################################################.....................################
###################.######################################################################.......................###############
###################.#######################################################################.....................################
###################.#######################################################################.....................################
###################.#######################################################################.....................################
###################.#######################################################################.....................################
###################.########################################################################...................#################
###################.########################################################################...................#################
###################.#########################################################################.................##################
##############################################################################################...............###################
###############################################################################################.............####################
#################################################################################################.........######################
#####################################################################################################.##########################
################################################################################################################################
###########################################.####################################################################################
########################################.......#################################################################################
######################################...........###############################################################################
#####################################.............##############################################################################
#####################################.............##############################################################################
####################################...............#############################################################################
####################################...............#############################################################################
####################################...............#############################################################################
###################################.................############################################################################
####################################...............#############################################################################
####################################...............#############################################################################
####################################...............#############################################################################
#####################################.............##############################################################################
#####################################.............##############################################################################
######################################...........###############################################################################
########################################.......#################################################################################
###########################################.####################################################################################
################################################################################################################################
################################################################################################################################
################################################################################################################################
################################################################################################################################
################################################################################################################################
################################################################################################################################
################################################################################################################################
################################################################################################################################
################################################################################################################################
################################################################################################################################
################################################################################################################################
################################################################################################################################
######################################################################################.............#############################
######################################################################################.............#############################
######################################################################################....................######################
######################################################################################....................######################
######################################################################################....................######################
######################################################################################....................######################
######################################################################################....................######################
######################################################################################....................######################
######################################################################################.............#############################
######################################################################################.............#############################
######################################################################################.............####....................#####
######################################################################################.............####....................#####
######################################################################################.............####....................#####
######################################################################################.............####....................#####
######################################################################################.............####....................#####
######################################################################################.............####....................#####
######################################################################################.............####....................#####
#######################################################################################################....................#####
#######################################################################################################....................#####
#######################################################################################################....................#####
################################################################################################################################
################################################################################################################################
################################################################################################################################
################################################################################################################################
################################################################################################################################
################################################################################################################################
################################################################################################################################
################################################################################################################################
################################################################################################################################
################################################################################################################################
################################################################################################################################
################################################################################################################################
################################################################################################################################
################################################################################################################################
################################################################################################################################
################################################################################################################################
################################################################################################################################
#####################.......####################################################################################################
################################################################################################################################
#######################...................######################################################################################
################################################################################################################################
################################################################################################################################
################################################################################################################################
