################################################################################################################################
##################........##########..###########################..##########..##########################################...####
#####.....................#########....###..##############....##.........###.....###################################..##.....###
####......................###...###...........#####...###.........................##########.....###..#############..........###
##........................###...####...........####...............................#########...............#########.........####
#.........................##....#######.........###................................########................#########.......#####
#.............#..................#######..............................................#####................##########.....######
##...........###.................######........................####............###.....#####........##.....##########.....###.##
####.........###..................##..........................#####...........#####....#######.....####...#####..###......##...#
#####.........#...............................##.............#####...........######.....#######....###########...........##....#
######............######.....................####.............###............######.....#######....##########..................#
######...........########..................######.............................#####.....########...##########..................#
#######..........########........###......######....S.............###............#.....#########...##########.................##
########.........########.......#####.....#####..................#######..............#########.....#########.............######
#########.........#######.###########....####................############.............########...........####.......############
##########.........######.##########....####...............##############.................###............###....################
#########...........#####.##########...####..............#################...##................................#################
#######..............####.##########...####.............#######...##############...............................#################
######................###.###########...###..........#.######.......############..............#####.............##..############
#####.................###.############..............#######..........###########.............######.....................########
######...............####..###########.............#######.....##....####.######....#........#####.....##................##..###
#########............####..##########..............######......##....###...###########................####....................##
###########..........####...########...............######............###...###########...............#####....................##
############.........####......####.................####.............##....##########................#####...................###
###########.....##..#####......###..................###.............###.....###..###................#######.................####
#########......###########..######..................###............###............................###########..............#####
###..##........####################................####........######...........................##############.........#########
###............#####################...........#######........#######..........................###############........##########
###............######################.........######..........#######.........................####.....#######........##########
####............###....########...#####......######...........#######......###.............######.......#####........###########
####....................######.....#####.....#####......###..########.....#####........#..######.......######.....##############
####.....................#####.....######...#####.......###..#######......#####.......##########.......#####......##############
####..................................##########........###...###.........####.........#########......#####.......######..######
#####....................####.....#############.........###...............####............######......#####...............######
######..................#####.....#####..#####............................####.............#####......####.............#########
########................####......####..............................##...#####..............####......####............##########
#########...............###........##..............................############.............####.......##.............##########
#########..............###.........................................#############.............##........................#########
#########....####......###.........................................##############........................................#######
###...###...#####......###.....##.................##.................###.#########..................##....................######
###...##....######.....###....####...............###......................########.....###..........####...................#####
###...##....######.....###....####................##......................#######.....#####.........#####...................####
###...###...#######....###....####.......................................#######.....######..........####...................####
###...####...#######...###.....##...................................##...######......#####...........####................#######
##....####.......###...##.........................................#####...#####.......####............##................########
#......##.........#..............................................#######...####.......####...........................###########
#................................................................#######....####......#####.........................############
#.................................................................#..###....####......#####.........................############
#............................####.....................###............###.....##......#####....###...................############
#......................##...######...................####............####...........######...####....................###########
##....................############...................####...........######..........#######.####......................##########
#######...............############...................####...........#######........#############.......................#########
#######..............#############...................####............#######......#############.........###.................####
#####...............###############...................##......###......#####......############..........###..................###
####................###############...........................####.......###......#########..............#....................##
#####...............################....#.........#...........###..........##....#########.......#.............##.............##
###########.........################...###.......###................#.......##############......###...........######.........###
############..........##############...###.......####..............###......#############......####...........#######.......####
############................#######...#####.......##...............####.....#######..####......###....#.......#######......#####
###########..................######..#######........................#####....######...####...........###.......#####.......#####
##########...................#####..#######.........................######.......##...####......................####.......#####
########......####...........#####..#####..........................#######.......###...##........................###........####
#####.........#####...........####..####..........................########......#####..........#.................####.......####
####..........####.............##...####.........................#######.......######.........###.................####......####
###.................................####.........................######.......######..........###..................####......###
###..................................###......................................####............###....................##.......##
##............................................................................###..............##.............................##
##...........................................................................####..............###............................##
##..........................................................................####...............######.........................##
##....................##....................................##..............####.......##############.........................##
##...................###...................................####.............####......###############..................#......##
##..................####...................................######..##........##.......############......##..........#####.....##
###...............######...................................###########.................##########......###..........#####....###
###..............########...................................##########..................#######........###..........######..####
##.............###########...................###............####...##.....................####.......................###########
#............##############....#...........######...........###......................................................###########
#...........######..########..##.........########..........####......................................................######..###
#...........#####.....##..#####..........#######...........####..........###........................................######....##
#...........#####..........###...........##...............####....#......###........................................#####.....##
#...........####........................................######...###.....##.........................................#####.....##
##...........###...............................###......###########.....##...........................................###......##
###.........................................######......###########....###.................##.......##........................##
###..............................####.......###..........###########..#####.............#######.....###.......................##
##..............................#####.....................#################............##########....##........................#
#.......##......................######.....................###############.............###########...............###...........#
#......####.....................###........................####..#######...............###########..............#####.........##
#.....#####..................#####....................###..###....#####................###########..............#####.........##
#....#####..................######...................#########.....##.................####..######..............#####..........#
#...######..................######....................########........................###.......#.......##......######.........#
#########...................######.......##............#######.........................#...............####.....######........##
#########...................######......#####...........##..#..........................................###.......#####.......###
########...................######.......#####.........................................................####.........##........###
########..................#######........####........................................................####...................####
#######..................#########........##......###.......................###...........##.........####..................#####
#####....................##########...............######...................####....##....####..##...#####.................######
#####...................###########...............#######..................####...####...########...#####................#######
#####..................###########................#######..................###...######..#######....######...............#######
######.................#########..................######...................###...######..######......#####...............#######
######.................####......................#######............###.....###########...####............................######
#######................###.......................#######............###......#########.....###.............................#####
##..##..........##....####........................#######..........###.......######........###...............................###
#..............###########.........####.............#####........#####.......#####........#####...............................##
#..........##.###########.........######..............##.........####.........###.......#######.....................#######..###
#.........####.###...####.........######................................................######.....................#############
#........####.........##...........#####..........................................E........##......##.....#........#############
##......####........................####........###.........##....................................#####..###.......#############
###....####..........................##........######......####...................................#########...........##########
###....####.......##.......................###########.....#####......###.........................#######..............#########
###....####......###.......................#############...#####...................................##..................#########
###....####.....####.......................######....####...###........................................................#########
###.....##.....######.............###.......####.....#####..............................................#..............#########
##......##....########...........#####...............######.............................................##............##########
##.......##...########...........#####..............########......###...................................#............###########
##.......###...######.............###...............#########....#####..............................................####...#####
##.......###........................................##########..#######.............................................###.....####
#........####.......................................####################................##...................................###
#.......######..................................##..####..##############...............####..................................###
##..###########................................###...##....#########.##...............####..................................####
###############..................###...........###............######...................##.........................##.....#######
################................#####...........#..............#####........................####.........##......####...########
#################..######.......######...............###.......####.....####..............#######.......####....####...#########
##########################......########.........###########....##.....######............#######.......######..####....#########
##########################.......########.......#############.........#######.............#...........############......###...##
##########################........######.......##############.........#######.........................###########..............#
##########################........#####......################........#########........................###########..............#
###########################......######.....##################...################....................#############....######..##
#######################################....#############################################.....###################################
################################################################################################################################
