################################################################################################################################
##############################################################################################################................##
##############################################################################################################................##
##############################################################################################################................##
##############################################################################################################................##
##############################################################################################################................##
##############################################################################################################................##
##############################################################################################################................##
##############################################################################################################................##
##############################################################################################################................##
##############################################################################################################................##
##############################################################################################################................##
################################################################################################################################
################################################################################################################################
################################################################################################################################
################################################################################################################################
################################################################################################################################
################################################################################################################################
################################################################################################################################
################################################################################################################################
################################################################################################################################
################################################################################################################################
################################################################################################################################
################################################################################################################################
################################################################################################################################
################################################################################################################################
################################################################################################################################
###############################################..............###################################################################
###############################################..............###################################################################
###############################################..............###################################################################
###############################################..............###################################################################
###############################################..............###################################################################
################################################################################################################################
################################################################################################################################
################################################################################################################################
################################################################################################################################
################################################################################################################################
################################################################################################################################
################################################################################################################################
################################################################################################################################
################################################################################################################################
################################################################################################################################
################################################################################################################################
################################################################################################################################
################################################################################################################################
################################################################################################################################
################################################################################################################################
################################################################################################################################
################################################################################################################################
################################################################################################################################
################################################################################################################################
################################################################################################################################
################################################################################################################################
################################################################################################################################
################################################################################################################################
################################################################################################################################
################################################################################################################################
################################################################################################################################
################################################################################################################################
################################################################################################################################
################################################################################################################################
################################################################################################################################
################################################################################################################################
################################################################################################################################
################################################################################################################################
################################################################################################################################
################################################################################################################################
################################################################################################################################
################################################################################################################################
################################################################################################################################
################################################################################################################################
################################################################################################################################
################################################################################################################################
##############################################################################################.#################################
##########################################################################################.........#############################
########################################################################################.............###########################
#######################################################################################...............##########################
######################################################################################.................#########################
######################################################################################.................#########################
#####################################################################################...................########################
#####################################################################################.................E.########################
#####################################################################################...................########################
#####################################################################################...................########################
####################################################################################.....................#############.........#
#####################################################################################...................########################
#####################################################################################...................########################
#####################################################################################...................########################
#####################################################################################...................########################
######################################################################################.................#########################
############################################.#########################################.......S.........#########################
########################################.........######################################...............##########################
######################################.............#####################################.............###########################
#####################################...............######################################.........#############################
####################################.................#########################################.#################################
####################################.................########..................#################################################
###################################...................#######..................#################################################
###################################...................#######..................#################################################
###################################...................#######..................#################################################
###################################...................#######..................#################################################
##################################.....................######..................#################################################
###################################...................#######..................#################################################
###################################...................#######..................#################################################
###################################...................#######..................#################################################
###################################...................#######..................#################################################
####################################.................########..................#################################################
####################################.................########..................#################################################
#####################################...............#########..................#################################################
######################################.............##########..................#################################################
########################################.........############..................#################################################
############################################.################..................#################################################
#############################################################..................#################################################
################################################################################################################################
################################################################################################################################
##################################...............###############################################################################
################################################################################################################################
################################################################################################################################
################################################################################################################################
################################################################################################################################
################################################################################################################################
################################################################################################################################
################################################################################################################################
########.#######################################################################################################################
########.#######################################################################################################################
########.#######################################################################################################################
########.#######################################################################################################################
########.#######################################################################################################################
################################################################################################################################
################################################################################################################################
