################################################################################################################################
################...........................................................................................................#####
###.#####......................########...########################....###................#########.........######......##..#####
##...###.........................##........########..####..###............................#######...........####.......##..#####
##...###......................................####.........................................######...........####......###..#####
##..####..............................###..................................................######............###...######...####
#...#####......####..........................................##............................#####.............###..######....####
#...#################................#####..................####....#######.................###..............##...###.......####
#....#################................####..................####...#########................................####.###.......#####
##.....################................###..###..............##...###########..............................########......#.#####
##........##############.......##......############..............####...#####.............###..............########.....##.#####
##................#######.....####....######..######.............###.....####............#####..............########....##.#####
##..................#####......############....######............###......##.............######..##............#####....##.#####
##.....###.............##......###########......#####............###.....................###########............####....##.#####
##.....####.............##.....#########........####............#####.........S..........###########............#####..###.#####
##......####............####..#########.......##.......###.....######...##................#########.............##########...###
###......####...........##############.......###......####....#######..###..................######......##.......#########....##
####.....####............###########......######....#####.....########.###...........##......#####.....####.......#######.....##
####.....####...##.......##########......#######...#####......###########...........####.....######..#######..................##
####......##....##........########.......########..#####.......##########...........####.....#################................##
####............##........................#######..######......###########...........##......##########....####...............##
####..........................................##...########....###########....................####..........##................##
####................##.............................#########...###########....................................................##
####......###......####.....##......................#########..###########....................................................##
####.......#......#####....####.....................##########.##########..................................................#####
####..............####....#####....................######################.........................................#........#####
#####.............####....#####....................#####################..........................................##.....#.#####
########.........#####.....###...............##...######################.................................................#.#####
###########......#####......................##....######...#####...#####....................#...............##...........#.#####
######..####....######................########...######.....####...#####...................###.............####..........#.#####
#####....##.....######................#########..######......###...#####...................####...........#####............#####
####.............#####................#########..#####........##...####....................#####..........######..##.......#####
###...............###...#..............########..####.........##...####.....................#####.........###########......#####
###....................###................#####...##.........##.....##......................######........###########......#####
###....................##..................####.............##.................##............#####.........##########.......####
###..........#.........................#..#####............###................###............####..............#####........####
###.........###.......................#########...........####..............#####...##........###...#######.....####.........###
####........####...........###.........########.....##...####......#.......####....####.......##...#########.....##..........###
#####........###..........#####...........####......##....##......####.....###......####.....###...#########..................##
######.......###...........####............##......###............#####...###........###....####...#########..................##
######........###.................................####.............####...###...............###.....########..................##
######........####................................####............#####..####...##.........###.......#######..................##
######........####................................###...........#######..####..######......###.......######...................##
##...##......#####.............................................#######....##...#######.....###........##......................##
##....##....#####..............................................####.............######......#.................................##
##....##########................................................##...............######..........................##...........##
##.....######.....................................................................#####.........................####..........##
###......##.......................................................................#####..........................#####........##
######.............................###...........................................######...........................#####.......##
#######......................###..#######.....................................########..............................######....##
########....................##############...................................#########.......................##.......####....##
#########...................###############..................................##########.......##.............##........###.#..##
########..##................###..#########.................##.................##########.......#.......#.....##.........##.#..##
#######...###.....................###................##...####..................########.......##.....###....###........##.#...#
#######...###.....................###...............####..####.......................###.......##.....####...######......#.....#
######.....#.....................###.........###....####...###........................##......####.....##.....######...........#
##..............................####........####....####..............................##.....######..............###..........##
##.............####............#####...##..#####....####..............................###....######...............##..........##
###............#####.........#######..###...###......##................#####..........####....#####...........................##
#######........#######......#######...##.............................########.........####.....####..........................###
########........#######.....######....##..........................############.......#####......###..........................###
#########........######......####.....###.................##.....#############......######......###..........................###
########..........####.......###......###.......#........####....#############.....#######.......#....................##.....###
#####........................###.......#.......###.......####.....#####...###......#######...........................###......##
###...........................###...............###.......##.......###.............#######...........................###......##
##............................###...............###...............................#######..............#.............##.......##
##.............................#............#...####..............................#######.............###............##.......##
###........................................###...#######.........................########.............####...........##.......##
####........................................###....#####........................#########.............####...........##.......##
####.........................................###....###.........................#########.......##...####...........###....#.###
####.................####.....................###...............................#########......####..###.............#...#.#####
###..................####.......................##...............................########......####..###.................#.#####
##...................####........................##............#..................###..##......####...##.................#.#####
#.................................................##...........##..........#......##............##.....##..............###...###
#.................................................###....................####.....##...................##........#######......##
#.............................................#######...................#####....###...................##........#######......##
##........................#..................########............###....####.....###...................###.......#######......##
##.......................###..................#######............###.....##.......##...................####......#######......##
##......................####..................########...........###.......................##..........#####....#########....###
##......................####..................#########.........####......................####........####################...###
##.....................####...................###########......#####.......................################################..###
##.....................###....................####..######.....####.........................####################################
##......................#..............##......#.....#####.....#####...........##............#############....##################
##..................................######............#####.....#######.......####............###########......############..###
##...#.............................########............####.....########......####...................####.......##########....##
###.###.............##..............######..............###......#######.......##.....................####.........###........##
######..............#....................................#..........####..............................####..........##........##
#####...................##..........................................####...............................##.....................##
###....................####...................................##....#####.....................................................##
##......................##....................................###..######.....................................####............##
##..............................#..............................#########......................................####............##
##...............###...........###.............................#########.......................................###...........###
###.............#####.........###.....##.......................#########....###..............................................###
###..............####........###.....####.......................########...#####.........................................#...###
####...............#........####.....####........#..................###.....####................#......................####...##
#####......................####......####.......#######.......................##...............###....................####....##
######.....................####.......##.........#######.......................................##...............###...####....##
#######....................###....................######........##.............................................#####...##....###
#######....................##.....................######........#####..........................................#####.........###
#######...................###.....................######........######.........................................####..........###
######...............#########....................######........######.........................................###...........###
###..............#############....................######.......#######....###..................................###...........###
###.............##############...........###......#####.......########....####................................#####.........####
###.............##############...........###......####.......#########....####................................######.......#####
###.............##############..........####.....####........########......##.................................######.......#####
###.............###############.........###.....####..........#####...........................................######.......#####
##...............########..####.........##......####...........................................................#####........####
#................#######.....##................######.......................##......###.........................####........####
#.....##.......E..##..........................#########....................####....#####..............##.........##.........####
#....####.....................................##########..................#####....######..............##...................####
##..#####......................................#########..................#####....#######.............###...##..............###
##..#####.....##...............#.......###......#######...................#####.....######.............#########.............###
##..####.....#####............###......####.....####..........######.........#.......#####............##########..............##
##...###....#########..........#.......#####....###..........########.................###.......#....###########..............##
##..........###..#####..##.............############..........########...........................##..############..............##
##................#########............############...........#######...............................############..............##
###................########............############............####.................................############..............##
####................#######.............###...#####.......................................................######.............###
#####...............######.....................####.........................................###............#####......##########
#####...............####.......................###.........................................#####............###......###########
#####...............###.............###.......####..................................###....#####....................############
####................................###......####..............###.................####....####......####..........#############
###................................####......####.............########............#####....###....########.........#############
##..............................#######......###.............##########..........######..........##########.........############
##....##.......................########.....####............############.........######.........#############........###########
###..####...######............##########...######.........###############........#######...###################.......###########
############################.#######################....###################.....################################....############
################################################################################################################################
