################################################################################################################################
##################################....##########################.#.##############################.#.#.############.#.###########
####.........#########.....######.......###########....#######..........#######################.......##########.......#########
####..........######.......######.......##########.....#######............####################.........#######........##########
###...........####...........#####........########.......#####..............###...############.........#####..........####.#####
###...........##.............######...........###........#####......................##########..........##............###....###
##...........................######.............#........#####......................#########.........................#......###
##............................######.....................#####........####............#######.........................#.......##
##.............................####.....................#####.......########..........######.................................###
##.................................#.....................####......#########...........###....................................##
##.....................................................#####......#####.....................................................####
##.....................................................#####......##................................#.......................####
##....................................................#####.......................................####......................####
##.....................................................###........................................####......................####
##................................................................................................####.......................###
###........................................................................###########.............##.........##.#...........###
##.............#.##.......................####............................#############.....................#########.......####
###..........######.......................######.........................#############.......................##########....#####
##.....###.########.......................########........................###########.........................#.########...#####
##.....############.........................###.####.....................##########..............................#######..######
#.......#####...............................###....##.....................######..................................#####....#####
##......###.................................##...........................#######....................................#......#####
#...........................................##...........................#####..............................................####
##...........S.............................###...........................####...............................................####
#...........................................###...........................#.............##....................................##
##.........................................#####.......................................####..................#................##
#...........................................####......................................####..................##................##
##.....#...................................######.......#............................###.....................................###
##.....#.................###...............######......###..........................####....................................####
##...###...............#####..............#######......###...............#.........###.....................................#####
####.#.................######..............######.......###............####......#####.....................................#####
####.#.......###.......######.................###.......##.............####.....####......................................######
##..........####.......######...................................############....####........#..............................#####
##..........#####......########..................................##########....####.......###..............................#####
#..........#####.......####.#.##......................................#####.....##..........................................####
#...........##.........####...####......................................###....###..........................................####
#......................##......###.....................................###......###..........................................###
#......................##......####.....................................##.....####.###......................................###
#.....................###......####....................................##......#######.......................................###
#..............................#####...............................#.#.###.....#######.................................#.....###
#..............................####...............................#######........#.#.................................#.#.....###
#..............................####...............................########..................................#......#####.....###
#...............................##................#...............#######...................##.............###....####.......###
#................................###...........#####..............#######..................####............###.....#..........##
##..............................#####.........#####......##.......#######..................###.............###...............###
##...............................######.......#####......####......#####....................###.............#.................##
###.............#...............########......###........####......#####.....................................................###
###...........####..............########......#............####......#.......................................................###
####..........#####.............########...................####.............................................................####
###..........######............########.....................####..............#####..........................................###
####.........######.............#####......................#####..............######........................................####
###..........######.............###.....................#.######...............######................###....................####
####..........#.##.....................................########.................#####................######.###.........#.######
###...................................................#########........#.........#####................###########.....##########
###...................................................########.......###..........####..................###########...##########
##................................#.#...............##########.....#####...........###.....................########.....########
##................................#####...........#.###.#.###......####.............###......................#.#####......######
##...............###.#.............####.........#######...###.....####.........................................####.........####
#...............#########...........####.........####......##.....###............................................###........####
##.........#.....#########..........####.........####.....###......#.............................................####.........##
#.........##.....#########..........#####..................##......................................................###........##
###.......#......#########..........#####................####......................................................###.........#
###..............#########........########...............###.......................................................###........##
####.............########..........######..............####........................................................###.........#
#####............#######............####............####.............##............................................#..........##
#####............##.#...............................##.............####...................####................................##
#####...........###................................................###..................######.........#......................##
#####...........#................................................#####..................#######.......###.....................##
###............##.............................................#.#####....................######........###....................##
###............##.............................................######.......................###.........####...................##
#.............##.............................................#######....................................####.................###
#..............##..............................................####......................................###.................###
#.............##.....##.......###.............................#####.......................................###...............####
#.............##.....##......######...........................####........................................##................####
#...........###.....###......######......................########................................................###........####
#..........####.....###....##########...#.................######..............................................#.#####......#####
#...........##.....#####...##########.####...............######.......................#......................#######.......#####
#..................#####.#################.....#..........####.......................###.....................########.......####
#..................#######################...####........#####.......................###.....................#######........####
#.................##################..###########.........####...####.................##.......##.#.#.#.#......######.........##
#..................################.....#########.#.......######.######.#....................#############.....#####..........##
#..........................#######......#######.#.###......####....###.##...................##############.......##............#
#............................###.........####....###......#####......#.#...................################....................#
#...........................................................#..............................###############.....................#
#..........................................................................................#############.......................#
#........................#..................................................................############.......................#
#.............#..........#.............................###.....................#####........##########.........................#
###..........###.........##..........................#####.....................#####.........#######...........................#
###.........####................#...................#######...................................####............................##
####........#####..............####................#######.....................................#.............................###
###........######..............####...........###.########..................................................................####
###........#######............#####..........####.#######..................................................................#####
##........#######..............####..........##.....#####.................................................................######
##........#####..............#####...................###..................................................................######
##........###..............########...................##......................#..........................................#######
###.......###.............#########.........................................####..........................................######
##........##.............############....................................######............#.............................###..##
##........####............#######.....................#.#.###...........#######...........##..................................##
##.......#####...........################...........#.########.........######.............###..................................#
##........####...........#######.#.######...........##########..........###..............###................#.................##
##.......#####...#......########......##............###########........####...............#................###.................#
##.......###.....####.#########.....................###########.........##.................................###.........##.....##
###.....####......##############.....................#########.........####.................................####.....####.....##
###.#.#####.........############....................##########.........#####................................####....###......###
############..........############..................#########.........######.................................#####...........###
########.#..............###########................###..#####........########..................................###.........#####
#######..................###########...............#......###........########..............................................#####
######.....................########.......................###.........########...........................................#######
#####........................######........................##...............##............##.............................#######
####..........................###..........................###...........................###.............................#######
####............................##.........................###...........................##...............................######
###.............................#..........................####...........................................................######
####............................##.........................###...........................................##................#####
###.............................##.........................###..........................................####................####
###.............................###......................####...........................................####................####
###..............................##......................####.......................................#######.................####
##......................................................#####.........................#.#..........#######..................####
##........................................................###.......................#######........######..................#####
##..........................#.............................###.....................##########.......#####...................#####
#...........................#......................#.##....##................E..############.......####..................#######
#..........................###.....................####...#####.#..............#########..........###....................#######
#..................................................####...########............###########..................................#####
#..................................................#############.......#.......#.#.#.####....................................###
#.....................####..........................###########........##..............####..................................###
##.......#..........#######........................##########..........###...#........#####...................................##
###......###........#######....................#.#.###########.........########........#####.................................###
#############################.#..#.#.#.#.#.#.#################........##########.....########......#......###.....###........###
################################################################################################################################
