################################################################################################################################
###.......................................................#####.......###################..................##.#.#.........######
###.............#####...................###...............####...........#.###########.....................................#####
##......................................##.................##.................######........................................####
###........................................................#................................................................####
##...........................................................................................................................###
###..........................................................................................................................###
###..........................................................................................................................###
##...........................................................................................................................###
##...........................................................................................................................###
##...........................................................................................................................###
#............................................................................................................................###
##............................................................................................................................##
#.............................................................................................................................##
##...............................................................##...........................................................##
#...............................................................####...........................................................#
##..............................................................####...........................................................#
##...............................................................#.............................................................#
###............................................................................................................................#
###............................................................................................................................#
###............................................................................................................................#
###............................................................................................................................#
####.....................................###..............#.#..................................................##..............#
####...............................#########.............####...................................................#..............#
####...............................##########............####.................................................................##
####...............................#.#######.............####.................................................................##
####...................................#####..............###................................................................###
####...................................####................##.................................................................##
###.....................................##................###.................................................................##
##.....................................###....................................................................................##
##.....................................####....................................................................................#
#......................................########................................##.............................................##
#.....................................#########...............................####.............................................#
##.........###.........................##......................................###............................................##
####...........................................................................###.............................................#
#####...........................................................................#.............................................##
####..........................................................................................................................##
####......................................................................##..................................................##
##........................................................................###................................................###
###..................#........................................................................................................##
##...................##.....................................................................................##................##
##...................##....................................................................................###.................#
#....................###...............................................##...................................##................##
##....................#...............................................##...................................###.................#
#......................................................................###................................###.................##
##.........................S.#........................................####...............................####.................##
#...........................##........................................#####..............................###.................###
##..........................##..............##........................###.#...............................#..................###
##..........................###............###.......................##.......................................................##
##.........................###.............##........................##.......................................................##
##..........................##.............##............##........##..........................................................#
####.......................................#..............##.#.#.#.###........................................................##
####.......................................#................#########..........................................................#
#####....................................##...................########........................................................##
#####............................................................####..........................................................#
#####.............................................................###.........................................................##
#####.............................................................##..........................................................##
####...#..........................................................##...........................................................#
####...##.........................................................##..................####....................................##
##.....##.............................................................................######................#..................#
##....................................................................................######...............###................##
#......................................................................................#####...............###.................#
###............................#.........................................................##................##..................#
###............................##..............................................................................................#
####...........................................................................................................................#
#####..........................................................................................................................#
####...........................................................................................................................#
###...................................####.....................................................................................#
##.....................................###......#..............................................................................#
##.............................................#...............................................................................#
##.............................................#..............................................................................##
###..........................................####.............................................................................##
###..........................................####...................####.......................#.............................###
#####.........................................###...................#####.....................###.............................##
#####...............#..........................#....................####.......................##............................###
###.#..............####...............................................#......................................................###
##.................#####.....................................................................................................###
#...................#####....................................................................................................###
#....................#####...................................................................................................###
#.....................#####..................................................................................................###
#......................###...................................................................................#...............###
#..........................................................................................................###...............###
#..........................................................................................................###................##
#.......................................................................##................................###................###
##.................................................##.........#........####...............................##..................##
#.................................................#.........####......####....................................................##
##.........................................................###.#.......###.....................................................#
#..........................#............................................#......................................................#
##........................##...................................................................................................#
#..........................##..................................................................................................#
##........................###..................................................................................................#
##....................#.#.####.................................................................................................#
##...................#########...................................#.............................................................#
###.................###########..................................##............................................................#
##..................###########..........######................................................................................#
##...................#######.###.........########..............................................................................#
#....................####.................#######..............................................................................#
##...........................................####.....................................................................##.......#
##.......................................................................................................##...........##.......#
####.....................................................................................................#.....................#
####...........................................................................................................................#
####...........................................................................................................................#
##................................................................................................E............................#
#.........................#.....................................................................##.............................#
#.........................##.....................................................................##...............##...........#
#.........................##......................................................................................##..........##
##.........................##....#.............................................................................................#
##.........................##....###............................................####..........................................##
####........................#....##.........................................#.#####............................................#
#######...........................##.......................................#######............................................##
#########..........................#..........................................................................................##
#########............##........................................................................................................#
##########...........###.......................................................................................................#
##########............##.......................................................................................................#
#########......................................................................................................................#
#####.#........#...........................................................................###.................................#
#####........#####........................................................................######...............................#
###...........#####........................................................................######.............................##
###............####...................................#...................................#############.......................##
##...............#..................................#.##...................................############......................###
##................................................###.###.................................#######.#.#.........................##
##...............................................####.####.........................#.......####...............................##
###...............................................###.#####........................##.....#####...............................##
####............................................###.....####...................#.####.....###.................................##
######..........###.............................###....######.................#########.######....................#...........##
########.......#####...........#..............####.....#######................################..................#####.........##
########......#######........############.#.#.######..##########.#..........#####################.##........#############.#.####
################################################################################################################################
