################################################################################################################################
########.........#.#.#.#.#.#.#.#####.#.#.###.........##.#.#.##################.#.#.#.######.#.#.#.###############..........#####
######............................................................######..............###...............######..............####
###.................................................................##....................................##.................###
##.................................................................###........................................................##
#.................................................................##..........................................................##
##...............................................................###..........................................................##
#...............................................................###............................................................#
##..............................................................##............................................................##
#...............................................................##...........................................................###
##..........................................................................................................................####
##..........................................................................................................................####
###........................................................................................................................#####
##.........................................................................................................................#####
###.........................................................................................................................#.##
###...........................................................................................................................##
###............................................................................................................................#
###............................................................................................................................#
##.............................................................................................................................#
##................###..........................................................................................................#
#................####...........................................................................#..............................#
#................####..........................................................................##...###........................#
#.................##...........................................................................##...####.......................#
#..............................................................................................#########.......................#
#...............................................................................................##..###........................#
#.............................................................................................................................##
#.............................................................................................................................##
#............................................................................................................................###
##...........................................................................................................................###
###..........................................................................................................................###
###...........................................................................................................................##
####..........................................................................................................................##
####...........................................................................................................................#
###............................................................................................................................#
##.............................................................................................................................#
#..............................................................................................................................#
#..............................................................................................................................#
#..............................................................................................................................#
#..............................................................................................................................#
##.............................................................................................................................#
#.............................................................................................................................##
#............................................................#................................................................##
#............................................................#................................................................##
#...........................................................##.................................................................#
#.............................................................................................................................##
#..............................................................................................................................#
#.............................................................................................................................##
#..............................................................................................................................#
#............................................................................................................###..............##
#...........................................................................................................####.............###
##..........................................................................................................#####.............##
##..........................................................................................................#####.............##
###..........................................................................................................###...............#
##............................................................................................................................##
##.............................................................................................................................#
#.............................................................................................................................##
#...................S.............................................................................###..........................#
#.................................................................................................#####........................#
#.................................................................................................#.###.......................##
#.....................................................................................................#........................#
#..............................................................................................................................#
#..............................................................................................................................#
#..............................................................................................................................#
##.............................................................................................................................#
##.............................................................................................................................#
###............................................................................................................................#
##.............................................................................................................................#
##.............................................................................................................................#
#.............................................................................................................................##
##.............................................................................................................................#
#.............................................................................................................................##
##.............................................................................................................................#
##............................................................................................................................##
##..........................................................................................#..................................#
#..........................................................................................###................................##
##....................##...................................................................##.................................##
#....................##.......................................................................................................##
##.............................................................................................................................#
#.............................................................................................................................##
##.............................................................................................................................#
#.............................................#.#.............................................................................##
##..........................................#####..............................................................................#
#..........................................######..............................................................................#
##........................................######...............................................................................#
##.......................................#######...............................................................................#
##.......................................#####.................................................................................#
###........................................#...................................................................................#
###...........................................................................................................................##
###............................................................................................................................#
##............................................................................................................................##
#.............................................................................................................................##
#.............................................................................................................................##
#.............................................................................................................................##
#............................................................................................................................###
##............................................................................................................................##
##............................................................................................................................##
##.............................................................................................................................#
#.............................................................................................................................##
##.............................................................................................................................#
#.............................................................................................................................##
##.............................................................................................................................#
##............................................................................................................................##
##............................................................................................................................##
##...........................................................................................................................###
#.............................................................................................................................##
#.............................................................................................................................##
#.............................................................................................................................##
#.............................................................................................................................##
#.............................................................................................................................##
#.............................................................................................................................##
#.............................................................................................................................##
#.............................................................................................................................##
#.............................................................................................................................##
#...................................................................................E..........................................#
#......................................##.........................................#............................................#
#.............................###.....###........................................###......##...................................#
#.............................##......###.........................................#.......###....##............................#
#.............................##......##..................................................####.####............................#
#.........................................................................................########.............................#
#..........................................................................................######..............................#
#...........................................................................................####...............................#
#............................................................................................###...............................#
#.............................................................................................##...............................#
#.............................................................................................##...............................#
#.............................................................................................###..............................#
#.........#.........................#.#........##.............................................####.........##.#..............###
##......#######.#.#.#.#.###########################.#....#.#.#.#..........................#.#######......#########.#.#.#.#######
################################################################################################################################
