################################################################################################################################
##...................................#################################...###...###############.......###########################
##.........############.########.......############..........#######..................................##...#####################
#...........###########.########........#########.............####..........................................###########..##..###
#...........###########.#########.......#######................................................................########.......##
#..........############.#########........######.............................................###.................########.....###
#.....#...#############.########..........######...........................................#####.................##..####....###
#.....############.####.########..........######..........................................######.....................####...####
##..#.###########...###.#....###..........#####.......##..................................######.....................####...####
#####.###....####.............###.........####.......###.................................#######.....................####...####
#####.##......####............#######.....###........###...............................##########..##................####....###
#####.##......####...........#########................#...............................###############.................###....###
#####.##.....####...........##########.................................................##############........................###
#####.#.....####............###########.........................................###......############........................###
#####.#....###..............###......#.........................................#####........#########........................###
#####.......#..............###................................................######.........#########..##...................###
###.......................###................................................######...........##..#########...................##
###........................#...............................................#.#####.................########...................##
###....##.................................................................##.#####.................########.............#.....##
####..####........................................##......................##.####..................#########..##.......##....###
#####.####.....................###...............####...............###....#.###...................######################...####
#####.###......................######............#####.............#####.....#.....................############..########...####
#####.##.......................######............#####.............######..........................###########....######.....###
###........###.................#######...........####...............#####................##.........###...####...............###
##........####..................####.............####................####...............####..............####...............###
##.......####.........................#######....####.................##...............####...............####................##
###.....####...........................#######...####......####........................###................####................##
#####...###.S............................#####....###.....######.......................###.................###................##
#####....##.............#.................####.....##.....######......................####.................###.......###.......#
#####.....##............##...............#####.............#####....................######..................###....######......#
#####.....####..........###..............#####..............####....................#####....................#############.....#
###........###..........######.....##....#####..............####..............................................############.....#
##..........##..........#############.....#####............#####............................#####..............##########.....##
##....####..............###########........#####........########.............##............######............................###
##....#####...............########.........#####.......#########............####....##......#..............................#####
##....######...............#####...........#####.......########............#####...####...................................######
##....######................###...........#####.........######............######...####...................................######
###.#.######..............................####...........####............########...##................###..................#####
#####.###..................................##.............##............##########.............#############................####
#####.##...............................##................................##..########.........###############...............####
#####.#..........................#....####...........##.......................########........################..............####
#####.#.........................###...####......##..#####.....................########.......##################............#####
#####.#................................##.....############....................#######........####################..........#####
#####.#....................................###############.....................####..........#############..########........####
#####.#.........###.......................################......................##............###########....########.......####
#####..........######....................##########...####.......##...........................##########......#######........###
##............########...................##########....###.......##............................#######.............#..........##
#.............########...................#########.....###.......##..............#...............####..........................#
#.............#######.....................#####........###......................###...............##.......##..................#
#..............###........................####.........###......................####......................####.................#
##........................................####.............................#.....####.....................#####...............##
##........................................#####...##......................###.....###.....###............#########............##
##........................................###########.....................###.......##....###........#############...........###
#.....................................#..############........###.........####........##....###......###########............#####
#.................###................#################.......###.......######........###....###.....########..............######
##..#.............###.................######.......####......####.....########..##..####......#.....#######...........##########
#####.#.......................###......####.........###.......##.....####..#############...........########..........###########
#####.#......................#####.....###............................##....###########............#########.........###########
#####.##...................#######.....###...................................########...............########.........###########
###...###..................#######....####.....................................#####..................#####..........###########
##.....##..................#######....####.............................................................###............##########
##............................####.....###..............................................................................########
##.............................###............###...............................................##...............###.....#######
##.............................###............####..............................................##..............#####....#######
##............................####............#####.............................................###............########.########
##.............................##...#....##..######.........................#...................#####..........#################
###..............###...............###..###########........................###...................######........#################
###..............###................###############.........................#####................#######.......######..#########
###...................................#############..................#.......#####................######.......#####.....#######
##......................##.............####...######...............####......#####.................#####........####........####
##......###.............##..............##.....######.......##########......#######................####.........###..........###
##......####....................................######.....##########......####..##...............####...........##...........##
##......####....................................#######....##########.....####.............##....####.............##..........##
##.......##.....................................#######....##########.....###.............##########..............##..........##
##.............#................................######......###..###......###............########............................###
##............###..............#........##......######....................####..........########...........................#####
##............###.............###......####......#####...................#####..........######............................######
###............###...........###......####.......########..............#######..........#####.............................######
#.#.............###..........###.....#####.......#########............########.............##..............................#####
#.#.............####.........###.....####........#########............#########.............##...###.........................###
#...............####.........###.....####.........########............#########.............########......###.................##
#...............####.........###.....####..........######.............########...............######.......###.................##
#................##..........###.....####.............###............#####....................####........####................##
#.#......###.................####.....##...............##...........#####...................................##...........##...##
#.##.....####................#####.....................##...........####................................................####..##
#.##.....#####..............######........###.......................###..........................###...................####...##
#.##.......####....#.....########......#######.....................####.........................####...................####...##
#.#.........#########...########......#########....................####........................#####...................###....##
#............########...#######.......############.................####.................#.....######....................#....###
#.....##......######....#######......######...####..................##.................###....#####..........................###
#.....###.....######....#######.....#######.....##................................##....##....####............................##
#.....###.....######....#######.....#########....................................####..........##.............................##
#.....##.......#####....######.....###########...................................#####.........##.....E........###............##
#...............####....####.......###########..................................#######........###............#####...........##
##........##.....####.............############.................................########....#..####......#....########..........#
##.......####.....####...........##############................................########...#######......####.###########........#
##.......#####....####...........#################.............................########...######........################.......#
#........#######..####...........####..############............................########....####..........##############.......##
#........############............####....##########...........................#######......###............#########........#####
#.....##..#########..............#####.........####...............##.........#######.......###............####..##.........#####
##....###..#######................####..........##................###.......#######.......................###..............#####
#####.###...#####..................##.............................####.....#######..........................................####
#####.####.........................................................####....#####.............................................###
#####.####..................###.....................................####....##...............................................###
#####.####.......###.......#####......................##............#####...........##.......................................###
####...####.....####.......########...................###............####...........##......................................####
####..##############......##########..................###............####................................###................####
####..#############.......##########..................####...........####...............................#####................###
####...######..####........#########..................####...........###...............######...........#####.....##..........##
####......##....####........#########..................##...........###...............#######............####....#####........##
#####............####.........#######..................##............#..........##########...............#####...######.......##
######...........####..........#######.................##.....................###########...............######...######......###
#######.........#####...........#######...............###....................############...............#####....#####......####
########.......######.............#####......##......###....................#############..............#####.....#####...#######
#########.....########............#####......#####...###....................######..#####..............####......#####..########
#########.....#########...........#####......######...##.............###...#######...###.......###.....####......####....#..####
#########......########.###############.......####.....##............####..#######...##.......#####....#####....####.........###
###..#####......#######.##############.................###...........####..#######............######...#############..........##
##....####.......######...############.................###............##...#######.............#####...############....##......#
##....####.......#####.....###########.................###.................#######...............###...###########....####.....#
#......##.......#####.......##########.................###.........##.......######......................#########....######...##
#...............####.........#########................###.........####.........####.....................#####........######...##
##..............####............######................###....#....#####.........#####......##............###.........######...##
###.............####.............####.................####..###...######........######....#####..........###.........#######.###
###.............####.............####........##.......########....############..#######..#######.........####....###############
####............#######..###....######......####..##.#########....##################################....#####...################
#########......################################################..###############################################################
################################################################################################################################
