################################################################################################################################
################################################################################################################################
######################...............###########################################################################################
################################################################################################################################
###############################........#########################################################################################
################################################################################################################################
################################################################################################################################
################################################################################################################################
################################################################################################################################
################################################################################################################################
############################################################################################################################...#
################################################################################################################################
################################################################################################################################
################################################################################################################################
################################################################################################################################
################################################################################################################################
################################################################################################################################
################################################################################################################################
################################################################################################################################
################################################################################################################################
################################################################################################################################
##########################################..........############################################################################
##########################################..........############################################################################
##########################################..........############################################################################
##########################################..........############################################################################
##########################################..........############################################################################
##########################################..........############################################################################
##########################################..........############################################################################
##########################################..........############################################################################
##########################################..........############################################################################
##########################################..........############################################################################
################################################################################################################################
################################################################################################################################
################################################################################################################################
################################################################################################################################
################################################################################################################################
################################################################################################################################
################################################################################################################################
#######################................#########################################################################################
#######################................#########################################################################################
#######################................#########################################################################################
#######################................#########################################################################################
#######################................#########################################################################################
#######################................#########################################################################################
#######################................#########################################################################################
#######################................#########################################################################################
#######################................#########################################################################################
#######################................#########################################################################################
#######################................#########################################################################################
#######################................#########################################################################################
################################################################################################################################
################################################################################################################################
################################################################################################################################
################################################################################################################################
################################################################################################################################
################################################################################################################################
################################################################################################################.###############
#############################################################################################################.......############
############################################################################################################.........###########
############################################################################################################.........###########
############################################################################################################.........###########
###########################################################################################################...........##########
############################################################################################################.........###########
############################################################################################################.........###########
############################################################################################################.........###########
#############################################################################################################.......############
##########################################################################################..........############.###############
##########################################################################################..........############################
##########################################################################################..........############################
##########################################################################################..........############################
##########################################################################################..........############################
##########################################################################################..........############################
################################################################################################################################
################################################################################################################################
################################################################################################################################
################################################################################################################################
################################################################################################################################
################################################################################################################################
################################################################################################################################
##############.#################################################################################################################
##########.........#############################################################################################################
########.............###########################################################################################################
#######...............##########################################################################################################
######.................#########################################################################################################
#####...................########################################################################################################
#####...................########################################################################################################
####.....................#######################################################################################################
####.....................#######################################################################################################
####.........S...........#######################################################################################################
####.....................#######################################################################################################
###.......................######################################################################################################
####.....................#######################################################################################################
####.....................#######################################################################################################
####....E................#######################################################################################################
####.....................#######################################################################################################
#####...................########################################################################################################
#####...................########################################################################################################
######.................#########################################################################################################
#######...............##########################################################################################################
########.............###########################################################################################################
##########.........#############################################################################################################
##############.#################################################################################################################
################################################################################################################################
################################################################################################################################
################################################################################################################################
################################################################################################################################
################################################################################################################################
################################################################################################################################
################################################################################################################################
################################################################################################################################
################################################################################################################################
################################################################################################################################
################################################################################################################################
################################################################################################################################
################################################################################################################################
################################################################################################################################
################################################################################################################################
################################################################################################################################
################################################################################################################################
################################################################################################################################
################################################################################################################################
################################################################################################################################
################################################################################################################################
################################################################################################################################
################################################################################################################################
################################################################################################################################
################################################################################################################################
################################################################################################################################
