################################################################################################################################
################################################################################################################################
##############################........##########################################################################################
##############################........##########################################################################################
##############################........##########################################################################################
##############################........##########################################################################################
##############################........##########################################################################################
##############################........##########################################################################################
##############################........##########################################################################################
##############################........##########################################################################################
##############################........##########################################################################################
################################################################################################################################
################################################################################################################################
################################################################################################################################
################################################################################################################################
################################################################################################################################
################################################################################################################################
##...................###########################################################################################################
##...................###########################################################################################################
##...................###########################################################################################################
##...................###########################################################################################################
##...................###########################################################################################################
##...................###########################################################################################################
##...................###########################################################################################################
###################################################################################.############################################
###################################################################################.############################################
###################################################################################.############################################
###################################################################################.############################################
###################################################################################.############################################
###################################################################################.############################################
###################################################################################.############################################
###################################################################################.############################################
###################################################################################.############################################
###################################################################################.##.........#################################
###################################################################################.##.........#################################
###################################################################################.##.........##############.............######
###################################################################################.##.........#################################
######################################################################################.........#################################
######################################################################################.........#################################
######################################################################################.........#################################
######################################################################################.........#################################
######################################################################################.........#################################
######################################################################################.........#################################
######################################################################################.........#################################
######################################################################################.........#################################
######################################################################################.........#################################
######################################################################################.........#################################
######################################################################################.........#################################
################################################################################################################################
################################################################################################################################
################################################################################################################################
################################################################################################################################
################################################################################################################################
################################################################################################################################
################################################################################################################################
################################################################################################################################
################################################################################################################################
################################################################################################################################
################################################################################################################################
################################################################################################################################
################################################################################################################################
################################################################################################################################
################################################################################################################################
################################################################################################################################
################################################################################################################################
################################################################################################################################
#######################################################################.########################################################
###################################################################.........####################################################
#################################################################.............##################################################
################################################################...............#################################################
###############################################################.................################################################
##############################################################...................###############################################
#############################################################.....................##############################################
#############################################################.........E...........##############################################
############################################################.......................#############################################
############################################################.......................#############################################
############################################################.......................#############################################
#######################################.####################.......................#############################################
#######################################.###################.........................############################################
#######################################.####################.......................#############################################
#######################################.####################.......................#############################################
#######################################.####################.......................#############################################
#######################################.####################.......................#############################################
#######################################.#####################.....................##############################################
#######################################.#####################.....................##############################################
#######################################.######################...................###############################################
#######################################.#######################.........S.......################################################
#######################################.########################...............#################################################
#######################################.#########################.............##################################################
#######################################.###########################.........####################################################
#######################################.###############################.########################################################
#######################################.########################################################################################
#######################################.########################################################################################
#######################################.########################################################################################
################################################################################################################################
################################################################################################################################
################################################################################################################################
################################################################################################################################
################################################################################################################################
################################################################################################################################
################################################################################################################################
################################################################################################################################
################################################################################################################################
##########################################################################.#####################################################
#######################################################################.......##################################################
######################################################################.........#################################################
######################################################################.........#################################################
######################################################################.........#################################################
#####################################################################...........################################################
######################################################################.........#################################################
######################################################################.........#################################################
######################################################################.........#################################################
#######################################################################.......##################################################
##########################################################################.#####################################################
################################################################################################################################
################################################################################################################################
################################################################################################################################
################################################################################################################################
################################################################################################################################
################################################################################################################################
################################################################################################################################
################################################################################################################################
################################################################################################################################
################################################################################################################################
################################################################################################################################
################################################################################################################################
################################################################################################################################
################################################################################################################################
