################################################################################################################################
################################################################################################################################
################.....###..##########...######..######..#####......###############..#####..#############.....####################
###############.........................####....###.....###........############....####......................###################
############..............................##.........................####.........#####......................###..##############
############...........###.........##......##.........................##.........######.............##......###....####...######
#######..###..........####......######..........................................#######.............###....###.....###.....#####
#######...###.....########.....########........................###.............########.............##.....###......##......####
#######...###....#######.......#########.......................###.............########....................###......###......###
########...#.....####..........##########.....................###..................###......................#........##.......##
########..........##....##.....####..#####...................####............................###.....................###......##
#######................#####....#.....#####...................##............................#####....................####.....##
#####.................#######.........######.................................................####...................#####....###
##....................########.........#####..................................................####..................#####....###
######................########.........#####.............####..................................####..................###.....###
#######................########........#####............######.........##......................#####.........................###
#######................#########.......######............######.......#####....................####..........................###
##...#..................########.......#########...........#####.....#######..................####.........................#####
#.......................#######...##....#########...........#####....#######..................###.........##..............######
#.......................######....##....#########............#####..#########.................###........######...........######
#......................######.....##....####.####.............###############..##.............###........#######............####
#......................#####.............##...###.............####################........................######.............###
#......##..............####..............###..###............###...##....#########.........................####...............##
##....###..............####..............###..###..........S###...........#########.................###.......................##
##....###..............####....................###...........#............##########................####......................##
###...................######....................#........................###########................#####....................###
###..................########...................................###.....###########.................#####...................####
###...............###########..........................##......#####....##########.....##............#####..#..............#####
###..............############.........................#####...######.....#######.......##..............######.............######
###..............############.........................###############.....#####........##...............####.............#######
###..............#######................#.............##########..##.......####.........................###..............#######
####..##........#######................###............#########............####...#....................###...............#######
#########......#######.................####...........########..............##...###..................####................######
#########.....########..........###....####.............#####....................###................#######................#####
########.......########.........####....###..............###.....................###...............########..................###
########..........########......####.....##.......................................###.......####...#######..........##........##
#########...##......#######......###.....###......................................####.....######...###............###........##
#################.....#####......###....#####.......##............................#####....######.................###.........##
##################.....###......#####..######........##..........................#######...#####.................####.........##
#####..############....###.....##############...##...#####.......................###..###...###..................#####........##
####.....###########..####....##############...####..############.................#....###.......................######......###
###........###############...###############...####...###########......................####........................####......###
##..........###############..#####......####...####.....#########.......................#####................................###
##..........##########..##....###.........#.....##.......................................#####.................##.............##
##...........########.........###.........................................................#####...............####............##
##.................##........#####...............................................###.......####..............#####............##
##..........................######..............................................####........###..............######...........##
##.........................#######.............................................#####........###................####...........##
###.......................#######..............................................####.........####................###...........##
###....#..............##########..................##..................###.....####...........##.........###............#......##
###...####...........##########...................###................#####....###......................####...........###......#
###....####........#######..###...................#########..........#####.....#........................###...........###......#
###.....####......#####....................####....#########.........####..........####................................#.......#
###......##.......####....................#######....#######...##.....##..........######......................................##
####..............####...................#########.....#####..####.................####......................................###
####..............#####..............#############......###...####..........................................................####
####...............#####............#############.............#####...................................#....###..............####
###................######...........#############..............####..................................##########.............####
##..................######...........#.....######...............##..............##....................#########..............###
##...................########.......#........####..............................####...................########................##
###...................################........###..............................####...................#####..............###.###
#####..................################........###..............................##...................#####.............#########
######..................###############........###...................................................######...........##########
#####...................###############.......####.....###...........................................#######.........###########
####........##...###....########..#####.....######.....####..........................................########........###########
###........#########.....######.....###....#######.....####....................................#################......##########
###........########.......####.......##....#######.....####......#######......................###################.....##########
##.........#######...................###....#####......####......########....................#############..#####.....##########
##..###.....#####...................####....###.......####.......#########...................############.....##.......#########
#....#.......####...................####.....#.......#####......###..######..................###########...................#####
#............#####...................##...............###......###....######..................####.#####....................####
#............#####.............................................###.....######..................##...####....................####
#...........#####..............................................###........####.......................###...................#####
#....##....#####......##......................................####.........###.............................................#####
#...####..#####...#######...##...............................#####........####.....##......................................#####
#...##########...#######...####.....................###......####...##########....#####.....................................####
##...########...#######...######.....................#........##...############...######....................................####
##.....#####...#######....#######.............................##...############...######...................................#####
##......###...######.......######.............................##......########.....####...................##...............#####
##.......#....#####...........##.............#................##.......######..................######....########..........#####
##............#####.........................###...............##........####...................#######....##########........####
##............######......##................####.............####..............................########.......#######........###
###...........######.....####...............####.............####...............................######...........####.........##
###............#####......####...............##...............##..................................................##..........##
####...........#####........##................................................................................................##
########......#######....................##......................................#............................................##
#########....#########...................###.........................##.........###.........#................................###
##########..###########...................#.........................####........###........###..............................####
########################....................................###.....####........##..........................................####
########################...................................#####.....##.........##..........................................####
##############..#########...........##.....................#####................###....##...................................####
#############....#########.........###............##.......######...............####..####............##....................####
#############.....##########........##...........####.......#####................#########....##.....#########..............####
############.......##########...................#####........####.................#########..####....##########.....###.....####
#########..........##########.............##########..........##....................############......##..#####....#####....####
########............###....##............##########.................................###########............###.....#####....####
########.................................##########.................................#########...............##......####...#####
########.........##.......................########................................######....................###.....####...#####
########.........###.......................######................................########........#..........###......##....#####
#######...........##........................#####................................########........##.........###...E.........####
######............##........................######....................###....#....######.........#..........###..............###
#####............###...........#####.........######....................#....###....####......................##..............###
####......##....####..........#######.........######........................###..............................###............####
###......##########...........########........######..........................................................###...........####
###......#########............#########........####............................................................##...###.....####
###......#######..............#########........####..............#.................................................#####.....###
####.........##..............#####.............###..............###................###.............................#####.....###
#####........................#####..............###.............###................###.............................#####.....###
#####.................##.....#####..............###.......###...###................####......................................###
######........##.....####....####....#..........###......#####..####...............####......................................###
######......####....#####.....##....##..........####.....#####...###...............#####......................................##
######.....#####...######.......................######...#####....###...............#####.....................................##
######....###.....######........................#######...####.....###...............####....................................###
######.....#.....#######..###..................########...####.....####...............##.....................................###
#####...........########.#####............#############....###....#####....#####.............................................###
#####..........########..#####...........#############..........########..#######.............................................##
######....############....###............#######...............##################.............................................##
#######..############..........................................##################....................###......###.............##
####################...........................................###################..........##......#####....#####............##
###################.............................................######..#############........##....#####.....######...........##
###############...................................................###....###...#######.......##########......######...........##
##############.........................##.................................#.......####......##########.......######...........##
##############......................#####..........................................##.......##########.......#######.........###
#############....................########.....###....##.....................................###########.....########.....#######
#############......###..........#########....#####..####..................##...............#############...#########....########
##############....#######......##########...############........###......#######..........###########################..#########
#########################################################..#########################..##########################################
################################################################################################################################
