################################################################################################################################
##############.................#######...#################....#####################....#########..#################.#####.....##
##...#####.........######......#####......####..#########......####...######............#######....####.....######...###.......#
##....##...........##...........###.......###....#######........##.....####...............####...............####.....##.......#
###................##...........##.........##....#######..................................###................####..............#
#####..............#...........##.........###.....####....................................###................####..............#
######.........................#..........###............................................####...............####..............##
#######..................................####...........................##...............###...............####...............##
#######...................................##.......#...................####..............###..............####................##
######............................................###..................#######............................####................##
#####..............................................#...................######.............................###..................#
#####.......................#.........................................#######..........................#...##..................#
####.......................###.................##....................########..........#..............###..##..................#
#####......................###.............#######..................#########.........########.........##...#..................#
#####...###................###.............#######..................##..####...........########................................#
######.#######..............##.#...........#######..................##..###.............###########...........................##
#######.######...............#.#............######............###...##..###.................########..........................##
######...#####..................######.......#####........#...###...##..###.......####......########............###...........##
####.....####....................#######.....####...###.####...#######...##......######.....###.####............###...........##
####......#.....................##########....#.....########...######............#######...###...##...........................##
####......................###...###########........#########...####..................#########...#............................##
#####...................######..###########.........##...###..####....................#######...##....#.......................##
####...........##.......##..#...#######...................#########.........#...................##....##....##...............###
###............##.....###.......######....................##########.......##...................##....##...####..............###
##.............#......###.......####.....................############..........................###........########...........###
##....................####.......##.......................###########.........................####........########............##
##...................########..............................##########.........................####........####................##
##...................##.######.....................##.......#..................................####....######.................##
##.......................#####.....................###......................####.................##...######.................###
###......................#####......................###..####..............######.....................######.................###
#######..........##......##........................############..##.......######......................#######.####............##
#######..........####...##......................###################......######........................###########............##
######...........####..###.........#...........#############...####......#.............................############..........###
#####............#####..###.......###.##.......####..###........###....................................##...########........####
####............#####...###...........####.....###.............#####.............................................####......#####
###.............####......#............###.....###...........########.............................................###......#####
##........##....###......................###...............###########.....................................................#####
##........###..........###................##...............###########......................................................####
##........####......#########..............##...............###########......................................................###
##..##....####.....###########.............####..##............########....#..................................................##
##..##.....##......###########.............####.####............#######...###.................................................##
##.###.............###########..............##..#####.............#####...###.............##............................##....##
#..###.............#####..####...................#####..###.........##.....##...........#####...........................#.....##
#...##.............####....##....................####...###............................######...#..................#.........###
#....##........S...####.........................#####....#............................############...............####........###
#....####...........###....##............##.....#####.................................###########..............#####..........##
##.....###...........###..###............#.......####................................###########.............#####............##
##...................#######......................####.....................##.........#...#####...........#######........##....#
##...................#######.............................................####..............###..........#########.......####...#
##...................#######..............................................##...............##...........##########.......#######
###..................#######..................#..........................#................###...#........##########........#####
###...................##...###...........#######..........................................####.###.........#########........####
###..........................#..........########.................................##........##.###...........########........####
###..........................#.........########..................................##.........................#######........#####
##...........................#........#####.......................................##..##.....................####......#...#####
#...........................##.......######..............#........................#######....................###......##...#####
#...................##.....###......#######.............###........................######...................####..............##
##.................####....###......#######.............###...............##........#####...................####.....#.........#
###................####.....##.....#####.##...............................##..........##....................#####...#..........#
##.................###............#####......................................................................########..........#
#.................####............####................................................................#......#######....###....#
#.................###..................................#..........................##....#............###......######....####..##
#................####.................................#####..............###.....####..###............#.......####......########
##.........##....####...##............................######............####.....####...#....###...............##.......########
##......######...###...####............................####.............####.....###.........####...................############
##.....######.....###.#####..............................................###.................####...................############
##...#########.#...########..............................................###...##..............##......................#####..##
#...##########.#....######.......#......................................####..###...............##......................###...##
#....#########.#....#####.......###.....................................########................###......................##...##
###.#...............####........####....................................#######..................##...........................##
#####...............####.........####...................................######.........####................###................##
######..............####.........####..................................#######........######.............######..............###
#####...............####.........####.....#######.....................#######.........######.............#######.............###
#####...............#####......#######.....######...................#####..............####..................##.............####
####.................#########.########.....####.....##............######.....###.......##.........................###......####
####.................#########....######............####...........#####......###......###........................#####.##..####
####.................#########.....######..........####.............###.......###....####.........................##############
#####................########......######.....##..####.........................##....####..........................#############
####.................########.....######.....###..####.........................##..................................#####.#######
##.....................#######...######.....####...##......###.................##............###...................####...######
#.......................##############......###.....#......###...............................####.................####.....#####
#..........................###########......###............###..........................##..#####...............######.......###
#...........................###########.....###............####........................####..####.............########........##
#..........................###############..###............####.......................####....###..............#######........##
#.......................#######################............................#.....##....#......###..................##........###
##.....................###################.###............................###....#...........####......#..........###.....######
###....................###.....##########..............#......##..........###...##..........######.....##...#########.....######
###.....................#.......#########............####....###..........###...........########.......#############......######
###..............................#########...........####...####.......................#########........############.....#######
####.............................##########...........###...####....##.................#########............#######.....########
#####............................###########....##.....#.....###....###.................###########..........#####.....#########
#####...........................#############...###...........###....#...................##########...........###.....##########
##.#..........................#################..##............###.............###.............###....................##########
#............................#######..#########..##.............###.........######....................................###....###
#.............................##.......#############.............###........#####....................................###.....###
#..........................................#########.............###.........###...................................####......###
#.........###...............................########..............###.........##.......###....##.........##.......#####......###
#.........####................................#####................##.........###.....####....###.......#####....#####.......###
##........###......#..........................####............................#####..####.....###.......######...####........###
##................###.......##...##..........####.............#.........##....#########.........###....#######...####........###
###..............####.....#####..###.........###.............###.......###....########............#....######.....###........###
####.............####....############........................##........###.....########...........#....###........###.........##
#########........####....############.................................####.....######.#................##.........##..........##
##########.......###......###########.................................###.....####....##.....................................###
##########.......###......###....####........................................####...........................###..............###
####..............#.......##.....####......................##...............#####..........................###...............###
###.......................##.......#.......###.....###.....##...............#####..........................####.............####
###............#..........###.............####....####......................#####..........................#####............####
###............##.........###.............###......##........................####..........................######............###
####.......###.###.........####...............................................##......................#....#######............##
#####......###.####........####......................................................................###...#######............##
######......##.####........#####...........##.........................................................#.....######............##
######......##.####........######.........####.........................................##.....................####......##....##
#####........#.####......#########........####............................##..........###.......................#.......##....##
####...........####......#########.......####.....##......................###.........###.............#.................###....#
####...........#####....###########......####....####..............##.....###....###..##.............###...##...........###....#
#####.....####.#####....####..#..................#####............####....###....###.................###...##...........####...#
######..######.#####...#####...#.........####.....###..............###....E##....###................####...##..........#####...#
###.#########...####...####..............####.....##................##...............................###.......####...######...#
##...#####......###....###.......................###..........................................................#####...##########
##...###........###..............................####..........................................................####...##########
##...###........###.............................######........##................................................##....##########
##...##....#....####............................######.......###.............##........................................#########
##........###....########.......................#####........###.............##..........................................#######
##........#####.#########......................#####.........###.............##.................###..........##..........#######
###.......###############......................#####.........###............###............##..#####.........###################
#########################......####..######...#######..##################..##########....############..#########################
################################################################################################################################
