################################################################################################################################
##########################.##.#.#.#.#########.#.#.#.############################################################################
###############..########....................................#######.........#####################################.#.###########
######...####.....########.....................................#................#.....###############.......####......##########
#####......#.......#######.............................................................####.########........###.........########
####...............#########...........................................................###....#####..........##........#########
###.................#########..........................................................#.....####...........###........#########
##...................#########....................###.........................................##.............##.......##########
#.....................###....###................######.......................................................##.......##########
##...........................###..............########....#..............##............................................#########
##............................###............########.....##.........#.#####.............................................#######
###..........................###............#########.....###......########...............................................######
###...........................##............#######........##.....##########..............................................######
##..................###......##............########........###.....##########............................................#######
##..................###......##...####.....#######..........#......#......###............................................##...##
##..................###.....####..#####...########..........................#.........###.......................###............#
##..........................#####################.....................................###.......................###............#
##..........................##############.#.####.....................................###.......................####...........#
##..........................############.......#......................................##.........................##............#
##..........................########..................................................###.......................####...........#
##..........................########..............................##..................###.......................###...........##
###.........................####.#.................................#.................####.......................#####.........##
###........#.##............#####..##...............................#.................####.......................#####........###
###........#####.......#.#.###.....##.........#...........................###.#......#####.....................#######.......###
###.......#######....########.....###.......####.........................########...######.....................######.......####
##.........#####.....####.#........##......####..........................##########.######....................######........####
##.........######.....#..........####.......###..............###.........#################....................#.............####
##.........#####................##.#........#####............###..........################..................................####
###.........#####...............#............######........................###############..................................####
#######.....####.............................#####..........................##############.................................#####
########.....###..............................####...........................##############............#.#####.............#####
########......#......................##.......###.............................#######....#...........########...............#.##
########............................###........##............................######.................#########.................##
########.............................##.......................................###.....................#####....................#
#######.............................##........................##............###.......................###......................#
######...............#..............###.......................##...........#...........................##......................#
######..............###.............##.........###...........####..........###.........................###....................##
#######.............###..............#.........###............##........................................###...................##
#########.##........##........................####..........................##............................##.................###
#########.###......###........................###............................##...........................##.................###
#########.##........##........................###...........................##............................###................###
###.#####.#........###.........................#........###.........................##.......................................###
#..................##..................................####........................###.......................................###
#.................###...........###..........#........####..........................##.......................................###
#.................##...........#####........###........#............................##.......................................###
#................###..........######......####......................................##........................................##
#.......................#############.....####......................................##...........####.........................##
##......................###########....#######......................................##..........#####..................#.......#
##.........#.#.........######..###.....#######......................................##..........####..................####.....#
##........#####.........####...........########................................................#####...................####....#
##........#####.........#####...........######..................................................###......................#.....#
##........#####..........#####..........######..............................###...............#####......................#.....#
##.........###.............#..............###....................S..........##.............#######............................##
##........................................###.............................................########............................##
###........................................##.............................................######............................####
###.......................................###.............................................######.............................###
#####.....................................###.............................#...............#####..............................###
#######.................................###..............................###...............###...............................###
########................................###.............................###.......##........##...............................###
##...............................##.#.###..............................###.......###........................................####
##................................###......................##############........##..........................................###
#...................##....................................#############.........####.........................................###
##..................###....................................##########...........###..........................................###
##.................####....................................####................####........................###................##
###...##...........###......................................##................####.........................############.#....###
###...####........####........................................................####..........................###############...##
##......##........####.......................................................#####............................#############..###
##......####.....#####.......................................................#####............................############....##
#.........##.....#####......................................................#######.............................##########...###
#.........###....####.......................................................######.....................................#......##
#..........###....####.....................................................######.............................................##
#........#####....###......................................................####..............................##................#
##.......######...###.......................................................##..............................###...............##
##.....########...##............#.......................########..............................###..........####..............###
#####################.........####......................##########..........................######........#####..............###
#####################.#.#.#.#####.......................##########.........................######.........######..........#.####
#################################....................######.#.#.#.........................####...........#######.#.......#######
######.#########################...........................................................###...........#########......########
####...########################...........................................................###...........###########.....########
####.....#####################............................................................###..........##########.......########
###...........###.#.#.#########...........................................................####........#####..####.......########
###......................#####............................................................#####......####.....###.......########
##........................######...........................................................####.......####......#.......########
##.........................#####......................................#####................#####......###..............#########
#...........................######....#...............................#######.#.#............##.........#..............#########
#...........................#######.####.............##.#.............############.....................................#########
#............................##########..............####.............##########.#......................................########
#...........................###########..............................#######.....................................#.......#######
#............................#########........................#####.######.....................................####......#######
#.......###.........................#..........................##########....................................#####.......#######
#.......###...................................................###########........##........................####.#.......########
#......####.......................................####........##########.......#####..............................#.....########
#......####........................................###.......#############.#.#.#####.....................###......###..#########
#......###................###.................................######################....................##.......####...########
##.....###..............#####.................................######################............................######..########
#......##...............#######................................#####################............................######....#.####
##.....###.............#########..............................######.#....#.....####...........................########.#....###
##....###..............##########............................####................####..........................##########.....##
###....##..............#########...........................#####................#####..........................##########.....##
###.....................########..........................#####..................###...........................##########.....##
###......................######..........................#####...................###............................########......##
###.........................##...........................####...................................................########......##
###.......................................................##......................................................#####.......##
###................................................................###...........................................#######.......#
###................................................................####.........................###................#####......##
###.................................####...........................####.........................#####................####......#
##..................................######...........................#...........................#####................###.....##
##..................................#######............................................................................#.......#
#.....................#...............#####...................................................................................##
##..................####................#......................................................................................#
#..........###.......##........................#.#...................#.................#......................................##
##........####.......##.......................######................##...................#.####................................#
#........#####.................................######...............#....................######...............................##
##.......#####....................................####.............##....................##.#.#................................#
#........#####.....................................####...........###.........................#...............................##
##.......#####.......................................###..........###..........................................................#
##.........##........####.......................................####............###...........#...............................##
##.........###.......####.......................................####...........######.........#................................#
###.................######.......#..........###................####...........#######........###..............................##
##.................########....#####.......####................####...........#######........##...............................##
###.................################.......#####.............####.............#######.......###...............................##
###..........#........###############.....#####............######.............#####..........#................................##
###..........#..........#############....#######...........######..............###.........###..............##...............E.#
##...........##.........#############....#######.........########..............##..........##...............####..............##
##..........####.........#############.##########........#########.......................#####.............#####...............#
#...........#######....############################....############......##..............####...............######............##
###.#.#.##############################################.#############...#######.#.#.#.#.########...........#########.#.#.#.#.#.##
################################################################################################################################
