################################################################################################################################
####.#......######################.#.##############.............#############.#.##########.#.####.#.############################
##..........##########........#........#####.#.#..................#####.###........#####.....#.........####.....#.##############
##...........########.................####..........................#................#.................###..........############
#............######...................###...............................................................##..........##.#########
##............###....................###...............................................................###...............#######
#...................................###................................................................####........##....#######
##..................................####...............................................................####........#......######
##.................................####...........##....................................................###..............#######
##...........................##....#####..........####.................................###................................######
##...........................###....###.............##................................#####..............................#######
##..........................#####...###..............................................#####...............................#######
##..........................####......................................................##...............................#########
##...........#.............######..............................................##......................................#########
#............#.............#####...............................................###...................................######.####
#..........####............######..............................................###.................................#.#####....##
#.........#####............#.####..................................#..............................................######......##
#.........#####.................#................................####.............................................#####.......##
#..........####.................................................#####.............................................###.........##
#....###...####....................................##......####...#....................................###....................##
##...#####.####...................................####....#######......................................####...................##
##########.####....................................####.########...............................###...#######.................###
##########...##...................................################............................##############..................##
#########....##......................#.............#######...................................################................###
##########....##....................##............###################......###...............###.#.#########.................###
##########.....###..................#............#####.#.#############....#####..............###........####.................###
##########.....######...............#............##......############.....#####.............##............#...................##
##########.......#####.....................###.####........#.....#####...#######.......###....................................##
##########.......######....................###.###................####.#.#######.....#########................................##
##########.......######....................###.####................##############....#####..#..................................#
#########.........#####....................#........................####################...###................................##
######............####...............................................###.#.#############....##.................................#
######..............#........................................................#########.....#####..............................##
#####........................................................................#########.....#####...............................#
######.........................................................................#####.....#########..........##................##
#####..........................................................................####......#########.........###.................#
######.................................................#................................##########..........###.......###.....##
#######...............................................####...............................########..........####.........##....##
#########.....................###......................###...............................########...........####.........#######
#########...................#######....................#####.........##...................######............###...........######
########................#######.#.##...................#####........###....................#####............####...........#####
######.................#####............................#####......####.....#...............##..............###.............####
####...................###..............................####.......####....####.............................###..............###
####.....................................................#.#.......####....###..............................####..............##
##.................................................................#####.............###....................#####..............#
##......#...........................................................####..............####..................#####..............#
##....#####..........................................................####............#####..................#####...#.#........#
##.....#####........................................................####.............#######................###.....####.......#
###....#####.................###.....................................####...........########.................#.....######......#
##......#####..S.......##########........####.......####............####............##..#####........................####......#
##.......####........###########.........#####.....#######..........####...........###....####......................#####.....##
##........###.#.....############..........####.....#########........####............#.....####.......................###......##
##.........##.#......#########..............#.......########..........#.............#.#...####................................##
##.........####.......########......................###.#.###.........................#######.................................##
##.........###.........######........###..................###.........................######..................................##
###.......####..........###..........###...............................................#####...................................#
##........####........................###...............................................###.........###........###............##
####.....####.........................###...............................####............####........##.........###.............#
####......#............................##.................................####.#.#........#..........#.......######.#.#.##....##
####...................................#...................................#########.....###.................###############...#
####........................................................................########......###..............#################.###
###.....................................#....................................######......####..............#####################
###....................................##.............##.#.#...................####......#####............######################
###.....................................##...........#########.....##............#......######.............#################.###
##......................................##............################..................######............################....##
###..........................###........###.............#############..................#####...............####...########.....#
##...........................####.......###..............#############..................###.................#.......#####......#
####.#.##...................#####.......##................###########...................##.......#..................#####......#
#########....................#####.....###..................#########..........................####..................###.......#
#########....................#####.....###.......................####..........................####..................###.......#
########......................#############.#.....................###.........................#####.........#.........#........#
####.#........................###############...........#.#........##..........................###........####...............###
###...........................################..........#####..................................####......######..............###
##............................################..........######..................................##......######.............#####
#............................#################...........#####..................................####...########............#####
#............................#################............###....................................###.########...............####
#...............#.#.#........################..............##.....................................##########.................###
###...........######.........################.......................................................######..................####
###..........#######.........##############...........................................................#.............##......####
####........######.........###############..........................................................................##.....#####
###..........#####.......#############..............................................................................####..######
###..........####........###########.###..........................................................................#######...####
##.............#.........###########.....#.##..............................#....................................###########.####
##.........................#######.....#########............#.............###.................................############...###
##...........................###........##########........###.............####..............................#######.#######.####
##.........................................#####.###....#####...............#..............................######....####......#
##.........................................###....##...######..............####...........................###........####...####
##....................................................######................###...###.....................##........####......##
##.....................................................####...............#######.#####..............................###......##
##...................................#................#####..........##...#####...######.............................###.......#
###.................................######............###...#........##########....######.............................#.......##
###.................................#######...........#.#######.....##########.......####......................................#
####.................................#######...............####.....##########........####....................................##
####..................................#####.................##.....#####.#####.........###....................................##
####........###.....................................................##...#####.........####...................................##
###........#####.............##....................................#.......####........####.................##...............###
###..........#................#............................................####........#####.......###......####.............###
##..........................................................................##.........#####......####......####............####
##......................................................................................####......#####......####..........#####
#.......................................................................................####........###......####.........######
#........................................................................................####.........#.......###.........######
#......#######................................#..........................................#####...........................#######
#.......########.............................##........###......................#.#........###...............................###
##.........#.####.......................................###...................########.....####...............E..#............##
#..............##.........######...........######.........#...................###.####......###..................###..........##
##.........................#######.........#######............................#.....####...#####................####..........##
#.........................#######.........########..................................####.#.#####.................###..........##
##.........................########.......#########...................................##########................###.........####
###.......................##########......########.....................................########........###.......###.......#####
####.......................##########......#######......................................#####........######.....###........#####
#####......................##########.......####.................................#.......##..........######.....####.........###
######......................##.######......#####.................................##......###.....#########.....####..........###
#######..........................###......####...................................##.......#......#########......####..........##
#######.........................####......#####...................................##......###..###########......#####........###
#######..........................##........###....................................#.......#########...#####.......####.......###
###.............................###..........#....................................##......#######.......###......######.....####
####.##.........................##........................................................#####...........#.......######....####
#######........................###.............#..........................................#####..................#######...#####
########.......#.#.#..........###.............###........................................####....................######.....####
#######........######.........####............#####...............................###.....###...................####........####
#######..........####........####...............#####.............................###....###....................##..........####
######.............#.........####.................#####..........................####....###................................####
######........................###.................#####.........................#####....##.............#.................######
#####.........................###..................####........................######....###............##................######
#######........................##.................#####.......................#######....##............####..........###########
#######......................######.........###.#.####.......................#########..#####..........####........#############
##########.#.###.#.#.........###########################.........#.#.########################......#.########....###############
################################################################################################################################
