################################################################################################################################
##############################################################...............................................................###
#########.......#####...###########.....###################.......#####..###########........############........######........##
########.........###....##########........###########.............####....#########...........########...........#####........##
###.####................#########.............####.................#......#########............######.............#####......###
##...###...............##########..............##.......#..................#########...........######.............######....####
##...###...............###########.............##......###..................####..###...........####..............######...#####
##...###...............###########............####.....###.........................###..........####......#.......#######.######
##..####...................########.........######.................................###.....##....###.....###......##############
#..#####........................####........#######................................###.....###....##.....###.......#############
#..####.....#.....###............##..........######................................###.....###...........###...........#########
#...##.....###...#####.....#...................####................................###...................####...........###..###
##.........##...######....###.......................................................###..................########.............##
##..............#####.....####............................###............S...........#...................#########...........###
##..............#####.....####.............##............#####...................##.......###............#########..........####
##.............#######.....##.............#########......#####..................####.....#####.....##.....########....##....####
##............#########...................##########.....#####.................######...#######....##.........###....####....###
##...........###########...................##########....######.###...........#################....##...............#####.....##
###..........############...................#########....##########...........################......................#####......#
###..........##..########.....................##...##...###########...........###############......................######......#
###...............########..............................###########............############.....................########.......#
##.................########.............................###########............#######.........................#####..........##
##.......................##.............................############..........#######..........................####...........##
##.............................................#####....#############........#######............................##............##
###.####.......................................######..##############.......#######....................................##.....##
#########...#########.............................####################......######................##..................###....###
#########..###########.............................###################......######...............####.........##.......##....###
#########..############.................###.........###################......####................#####.......####............###
########...#############.........###....###..........##.....#####..#####......###.................#####......####............###
#######.........########.........###.....#.....###..................####......###.........###.....####........##.............###
###..............######..........###..........#####..................###......###.........####.....##........................###
##...............#####..........####..........######.................##......###.........#####...............................###
##................####..........#####..........#####....###..........##......###.........######..........................#######
###................###..........#####...........####...#####.................####.........######...................#############
###................####........#######...........##....#####................#####...........#####..............#################
###................#####...###########.................#####...............#######...........####..............###...###########
###................##################.................#####...............#########..........####..............##.....##########
###................##############.....................####...............##########...........##......................##########
###................###########.........................###...........#############...................................###########
###.............##.......###.................###.......###.........###########..................................################
###............###..........................#####......###........##....#####..................................#################
###...........###...........................######....#######.######.....#####......###.......................##################
####.........###...........................##########.#######.#####........####....####.......................##################
######......###...........................###########.#######...##..........####....##.........................#################
######.......#...........####...........###########......###................####.................###......#....#################
#######.................######.........###########........##.................##..................####....###..#############..###
#######.................########.......######....................................................####...##################....##
######............#......########......#####......................................................##...###########..#####.....##
#####............####......######.......####.........................................###..............############....##......##
#####.............####......####........#####......................................#######...........##############...........##
######.............####.....###........######...............#.....................#########..........#######.....##..........###
#######.......#......#.....####......########..............##.#..................##########...........#####................#####
###########..###..........####......########...............##.#..................###..#####............###................######
################..........####......#######...............###.#..................##....###...............................#######
###############...........#####..#########...............######..........................................................#######
############..............################................#####..........................................................#######
###########................##############...................##...................................##....###........##.....###..##
###########.................#############.......................................................####..#####......####....###..##
##...######.......................#######.......................................................############.....#####...###..##
##....#####...........##...........######.................................................###....############....######..###...#
##......####..........###...........####............................................##....####...#############..#######...#....#
###.......##..........##......................##....................................###...####....#####..#############.........#
#####......##................................###.....................................##............###....############.........#
#######....###...............................###.....................................##....................###########.........#
#########...###.............###..............###.............................................................##########.......##
##########...#............######............###...............................................................#########.......##
###########.............########............###....................###.........................................########.......##
###########............####.####............###.................######..................##.....................#########.....###
############..........####...####...........###................######..................####.....................##########..####
############.........#####....####..........##.................######.................#####...........##.........###############
############........#######.....###........###..................####..................#####..........####.........##############
############........########.....#........####...........#......####..................#####.........####...........##.####...###
###.########.........#..####..............####..........##......####...................####........#####...............##.....##
##...#######.............###..............####..........#.......###.....................###........####....##.........###.....##
#...#######...............................###...................###.....................####........##....#########..###.......#
#....###..................................###...................###........###.........######.............##############.......#
##.......................................####...................####......#####.......#######.............#######..#####.......#
##.......................................####.........##........#####....########....#######..............###.........###.....##
#........................................#####.......####........####....###############...............................##....###
#........................................######.....######.......####....##############......................................###
##........................................######....#######......####....######...####.......#...............................###
##.........................................#####.....######.....####.....#####..............###...............................##
##..................##......................####......####.......##.......###...............###...............................##
###................######...........###......##........##...................................##.........##.....................##
#####..............#######.........#####.....##................................####...................####....................##
######..............######.........######....##.......................#.......#######.................#####...................##
#####...######.........##..........######............................###.....#########................#####...................##
####...###########.....##..........#####.......................##....###....###########...............####............##.....###
###....############....###.........#####......................####....###..############..............####.............##########
##......###########...####..........#####....................#####.....################..............###...............#########
##.......#########....####............####...................#####.......#############..............####................########
##........######.......................###..................#####..........##########................##..................#######
###.......#####........................####................#####.............####.........................................######
#######....####.......................##########...........#####..............##.........................#.................#####
########...####................###....###########...........#####.............##.........##.............##......##..###.....####
##..####....##.................###.....##########.....####...####............###........###...................##########.....###
#....##........................####....##########....######...##.............###........###..................############....###
#..............................#####...#####.###.....#######................####.........#..................#####..#######....##
##...............###...........#####....##...........########..............#####............................####....######....##
####............#####...........###..................#####................######............................####.....####.....##
#####...........#####.................................###.................######............................####.....###.....###
######..........######.............##..................##..................####......#..##...................###.....##.....####
######...........######...........####.................###...........###...###......########..................##.....##.....####
#####...............####..........####........#.......#####..........########........########.......##.........##....###....####
##........##.........##............##........###.....#######.........#######..........########.....###.........##....###....####
#.........##.................##..............###....########............###...........########.....##..........##.....#.....####
#.........##................####.............###....##...##...........................#########...###.........###...........####
#...........................####.............##......................................######..#######..........####...........###
#............................####.............................................####...#####....#####...........#####..........###
#..........###................####....................................###....######............###............######.........###
##..##.....###.................#######.......................###.....#####...######...........................######.........###
#######..........##.............########....................####....#######...#####...........................#######.........##
########.........###.............#######......###...........###.....#######...#####..........................########.........##
########.........####....##.......##.........####..........###.......#####....#####.......................###########.........##
#########........####...######...............#####.........###........####.....#####.....................############.........##
##########........##....#######..............#####.........###.........####.....#####....................####...######........##
###############.........#######...............####.........###..........###......####...........................#######......###
###############.........######............#....##.........###......E....####......##............................########.....###
###############.........######...........###...........#####.............#####..................................#########....###
################........#####......##....###..........####................#######..............................####..#####...###
##########...###.........###.....####....####.........###.............#....#######............................####....##########
##########....#...........#......####....####..........##............###...#######............................####.....#########
###########......................####....####.........####...###.....####..######........##....................##......#########
###########.......##.............#####..####......###############...#####...####.........##............................#########
###########......####............############....########################...####........###............####...........##########
###########....#######....#######################################################......#####....###...######.........###########
################################################################################################################################
################################################################################################################################
