################################################################################################################################
########.............................................................###.....#####.....#########################################
########.######.###########################.................######...###...#####.........#####################......#.##########
########.######..#########################....................#####......................###################..........##########
########.####.....#####..##################...................####.......................#################.............#########
########.####....######...##########...#####..................######......................##############................########
########.###......###.....#########....#####..................######.##...................#########.....................########
########.#................########......#####..................#####.###........................#........................#######
########.................########........###....................####.####.......................................###......#######
########.................########..........#......................##.#####.....................................####......#######
#######..................########.................................##.#######....................................####....########
#######..................#########.................................#.########..................................####.....########
#######.....###..........#############.................#.........###.########...................................###....#########
#######.....###.........################......#.......###........###.##########......##.........................##......########
#######.....#####.....#.#################.#.#.#.......###......#####.##########....####.#.##.....................##.....####...#
#######.......#......##########################......#####...........####...#####.###########....................#......####..##
#####................###########################.....###########......##.....#########.#######....................#.....###....#
#####.................#########################......#########................#####......#####....................#......##...##
####..................##########################.....#########.................###........####.......#............##...........#
#####...................#######.#.#.###...#####.......#######..............................###.......###...........#..........##
#####.....................####.............####........#####...........S....................##.......####.........###..........#
######.............#......####..............#...........####.......#........................#..........###.........##.........##
#######...........###.......##...........................#........##.##.......###.....####.............###........###........###
#######..........#####......##.........................#..........##.##.......###.#.########.............#........##.........###
####..##..........####................................##.............###.......##############.....................###......#####
##........#.......#####...............................##.............###.......###############.....................##......#####
###......##........####.................#............................###........######....#####......##...................######
##..................####.............####............................###........######......###.....####..................######
###..................###...........####..............................#..........#####......####....#####................########
###....................#..........###...........................................######......###....#####................#.######
#####.............................##............................####............######.....#####..######...................#####
#####.#...........................#.............................###..............######....##############....................###
########.........................#...............................###.............#####.....##############....................###
########..........................................................##...............###.....################....................#
####.#..........#####......................................................................####.#...########..................##
##.............#######......................................................................###.......#######..................#
#..............########.....................................................................#.........######..................##
#..............#######.......................................................................#..........##.....................#
#.............#########......................................................................#................................##
#..............#######.......#..............................................................####.#.#...........................#
##.............########.....##....................................................##........###########.......................##
####............#######...........................................................##........###..######...............#........#
###................#####...........................................................###......###....######.###############.....##
###................#####...........................................................###.....###.....####..#################.....#
###.................#####...........................................................###....####......###.###############......##
###.................#####............................................................##....####.....##....#####.#####.........##
###.................######..........................................................###.....####...........##.....#..........###
###................###########........................................###...........###.....########.........................###
###................###########.......................................####..........####.......######.........................###
###.................#######.#........................................###..........#####.........##..........................####
###..................######...........................................#...........######...........................#.##......###
###...................####........................................................######.................##.....#######......###
#####.................####.........................................................########..............##...#########.......##
######.........#.......####........................................................##########.............#...#######.........##
######.......######....#####.......................................#................###########...................###.........##
##...#.......######.....#####......................................#.................###########..............................##
#...........#####........####.....................................##.##................#.#.#.##...............................##
#...........#####.........##......................................##.###......................................................##
#...........####.................................................###.####.....................................................##
#...........#####...............................................####.####.......####..........................................##
#.....##...#########...............#............................####.####........####.........................................##
##...###.###########...............##..........................#####...###......#####..................................###...###
###..###.###########...............####.......................######...###.......##.........................####......##########
########.##########................####.......................######....###.....####.......................#####......##########
########.###########................###......................#########.####.....###.......................######......##########
########.#.#########.#.#............##......####..............##############....#####....................######.......##########
#######.....###############.................####..............##############.....####....................#######....#.######.###
######.......################...............######..............######.######....#####..................#########.##########...#
#####.........########..######...............#####..............####...######.....######...........#.....#################.....#
####.........########....####..................######.####..............####.....##########.......##.....###########.#.#.......#
###..........########....######...#.#.............########.............###.......................###.......#######.............#
###........##########...........######............#########............###......................####......#######..............#
##.........#########.......###########..............#######............#........................###.......#######.............##
##...##..##########..............###..................#.###.....................................#........########..............#
##################.........###..........................####.............................................#########.............#
#########.#######...........#............................##.............................................###########............#
#######.....#####..........##...........................####.............................................##.#.######.#.##......#
######.......#####..........##...................####...###...................................................############.....#
#####..........####..............................###########...................................................###########.....#
##.#............####........###................#######...##........####........................................##########.....##
##................#..........##................########..........########......................................#########.......#
#............................................########...........#########.........................##............########......##
#............................................########.#.#........#########........................###..........########.......##
#......................................###.################......#########.........................##...........######.......###
#.......................##.............#####################.......########.....#...................#...........####.........###
#.......................##............######################......#########.#.######.............................#..........####
#..............###.....###............######################.......################..........................................###
#............#####.....###............#################...........################...........................................###
#.............######..###..............################.............#....########.............................................##
#.............###########...............##############....................#######...............##............................##
#...............#######.................################...#...............#####........##.....####............................#
##..............########.........####.##################.###................#####......###.....#####.........##...............##
#...............#######..........###########################.................####......####....#####........#########..........#
##..............#########.........##########################.................######.#.#####...######........#.#.######........##
##......#.....###########.........##########################......####.......################.######...............#####......##
###########...############.........#########################.....######.......######################.......#.......#####......##
###########.####...#######..................################.....#####........######################.......#........#####.....##
###############....#####.#....#.#...........################......####.........######################......###.....#####......##
##############......#.......######...........############.#.......###...........#############.#######.......##....####........##
##############.............########..........############........................#.###.####.....######......###....#.........###
##############..............########.......############.........................................#####.......####.............###
#############...###..........#########################...........................................##.#......###..............####
########....#.#.##...............###################......................................................####..............####
#######.......####................#################.....................................................#####..............#####
######........###..................###########.........................................................#####..............######
######..............................#########.............##..........................................#####..............#######
#####...............................########..............##..........................................###................#######
#####.................................#####...................................................#......####..................#####
####..................................###.....................................................##......#......................###
###......####........###.................................E........###.........................#.......##.....................###
##......#######.....####..........................#...............#####...............................##.#.....................#
##......#.#.#############..........#.#...........####..............###................................#####...................##
###............#########..........####...........#####.............####.................................##.....................#
##.............#########.........####............######.............###..................................................##...##
###.............########.........###..............#####............####.................................................#####.##
##..............########........###...............#####...........#####.................................................########
##...............########........##..............#######.....................................##.........................########
###.....###......########........###.............#######........###..........................##........................#########
#############.....########.......####...........########........##..........................####........................########
#############.#.....######........########......########......####.........................#####.........................#######
################.....######........#########......######......###.........................#####............................#####
#################.....#####..........######......########....####.........##.............####.........###..................#####
################.....######..........#######......#######....###.......#######...........####........#######..............######
################...#.#####.............####.....########.....####.....###########........##..........#########.........#########
##############...##########...........#######.#.#########...####......############.......###........############.....###########
##############...#########............##################.....#####...#############......####....#.#.############################
##############.#############.........#####################.#########################...#########################################
################################################################################################################################
