################################################################################################################################
#########.#.##################################........##############################..#################.......#.###########.####
#########......#########################................#########....###.#########.....############.#..............######....###
#######........#############.#.#######..................#####.##...........#######......########...................#####......##
###.#...........##########.......####..................###................#########......#####.......................#........##
###............#########.........###...................##..................########.......####.........###.....................#
#..............#######............##..................##...................########........####......######...................##
#...........###########.........###...................#.....................######.........#######.########....................#
#.........############........#####..................##.......................####..........###############...................##
#.........##############.....#####...................##......................................#############.....................#
#.........##############......###....................#..............................#.........###########.....................##
#..........##############...........................###............................###.........########.......................##
#............############............................#................#.............#............#####.......................###
#............##########.....................##........................###........................####.......................####
#.............##########....................#..........................###........................##........................####
#...........###########.....................#..........................###.................................................#####
#...........############................................................##.....#.............................................###
#..........############...............................................###.....###...........................##...............###
##.........#############..............................................##.....####..........................###................##
##..........###########.......................................................##...........................###................##
####..........########.....................................................................................#.#.................#
####.............####.........................................................................................................##
####...........................................................................................................................#
###.........................................##................................................................................##
##.........................................####.....#.##.......................................................................#
##....................................#....####.....#####.............####....................................................##
##..................................##########.......####.............######...................................................#
#...............................#.##########..........###.............#########...............................................##
##..........#..................##############...........................#########.........................##...................#
#..........####...............#####.....####..............................#######........................####.................##
##.........####...............####.......####..............................................#............####..................##
##.........#.###..............####........##..............................................####.........#####.................###
###...........................###.........................................................####.........#####.................###
###............................###.........................................................####.........###..................###
##...........................................................................................#..........#....................###
###............##................................................................................................###.........###
##.............#...............................................................................................######........###
###.....##.......................###..............................................................##..........######.........###
##.....####.......................###.#.##........................................................##.........#######.......#####
###.....###........................##########.....................................................###........#####........######
##.....####.................#......############.............................................................####..........######
##......###................###.......###......########.......................................................#...........#######
###....####................####...............########............###..................###...............................#######
##.....#####...............####.................#######.........#####.....###..........####.........###..................#######
###..#######............#...####...............#######..........#.#.#.....#####.........####........####.................#######
####.#########..........##..####................#####.....................#####........#####.......#####................########
################.......###...####...............#...................#.......###...###..#####......########.............#########
#################.......###..####.................................####......##.....########.......########.............#########
####.#.##########......####....#.................................#####.............#######........########.............##.#.####
###......#####..........###......................................######..............######........######.....................##
##........##.............##......................................#####...............#####........#######.....................##
##................................................................####...............######........#####.......................#
##S.........................................................##........................###.........#######......................#
##...........................................................##......................####........#######.......................#
###..........................................................##.......................##.......##########......................#
####.................................#........................#......................###.......#########.......................#
####................................####...................................#..........##........#########.....................##
####...............................#####.................................####........###..........###.#.............##........##
####................................##..................................#####........####...........................###.......##
##.....................................................................####.#......######..........................####.......##
##.....................................................................##..........########.........................##........##
#.......................................................................#..........########........................####.......##
##...................................................................................#.######......................###........##
##.........................................................#.............................####......................#####......##
##........................................................####................#..........#####...........###.....########.#.####
###.......................................................####...............###..........#####......########....###############
###........................................................#####.###..........#...........#####......#########..################
##.........................................................#########........................##........#######....###############
##...........................................................##.####...................................#######....##############
#.......................................................................................................#####..........#########
##.......................................................................................................####............#######
#....##...................................................................................................##.............#######
#########..............................#.##.........................................##....................##...............#####
##.######.#..........................#####..........................................###....................................#####
##.###########.......................###...........................................#####....................................####
#....#########.................................##..................................######..........................###......####
#....#######..................................###..................................######..................#.......###.......###
#....#####....................................####..................##.................#..................###.....###........###
#....####....................................#####......#...........#.....................................###.................##
#.....###....................................#######.#####.................................................#..................##
#.....###....................................##############....................................................................#
##......#....................................###############...................................................................#
#............................................###......#######.............................###..................................#
##......................................................######...........................######.#.............................##
##.......................................................######................##.........#########...........................##
#####.....................................................#####......##........##........###########.........................###
######.....................................................####......###......###........###########.........................###
#######......................................................#......###........##........###########........................####
########............................................................###.......###.......#######.#.#..........................###
#########.......##............................................................###........####...............................####
#########...#.###.............................................................###......#.###.................................###
#########.#####...............................................................###......#.#..................................####
#######.....###................................................................##.....####..........................#......#####
########....###...............................................................###.....###.........#................####...######
#######......#...........................................##....................##.....####.......#####.............#############
########................................................####...................##......###........####............#######....###
#####...............................#...................#####..................###.....###.........................##.........##
###.................................##.................########.#.#............###.....####...................................##
###.................................#..................##############..........##.......###...................................##
##...................................................################...................####..................................##
###................................................#################......................#....................................#
#######...........................................####..##########............................................................##
########...........................................#......######...............................................................#
#######.....................................................##................................................................##
#######..............................................................#.#.#.....................................................#
######..............................................................########.......E..........................................##
######..............................................................##########................................................##
####................................................................##.....###..................##............................##
####....................#..........................###......................###................##.............................##
##.....................####.......................####........................................###............................###
##.....................######...............##########........................................##.............................###
##......................####..............###########.......###..............................................................###
##........................................###########.......###..............................................................###
##........................................##########..............................#...........................................##
###.........................................#######...............................##..................#........................#
###.........................................#####..................................#.................###.........##...........##
###...........................................###....................................................###.......#####...........#
##............................................##...................................................####........####...........##
###...............#######......................###.................................................#####......####............##
##...............##########....................####..........###..................................#####.......###.............##
###...............##########...................#####.........###...................................#####.....###.............###
###.................###................#........#####.......#####..........###.....................####.......#..............###
###.....###.........###...............###.......#####........#####.......######.....................####....................####
##.....####..........#................###........#####......#######......#######....................###......#..............####
###.....#####.......###...........#######........#####.......#######.....#######....................####.....###...........#####
###...#######......####.........##########........#####....###########.##########..........####.....####...######..........#####
#########################.#.##############.#.#..#####################################.#.#######....################.#....#######
################################################################################################################################
