################################################################################################################################
################################################################################################################################
################################################################################################################################
################################################################################################################################
################################################################################################################################
################################################################################################################################
################################################################################################################################
################################################################################################################################
################################################################################################################################
################################################################################################################################
################################################################################################################################
################################################################################################################################
################################################################################################################################
################################################################################################################################
################################################################################################################################
################################################################################################################################
################################################################################################################################
################################################################################################################################
################################################################################################################################
################################################################################################################################
################################################################################################################################
################################################################################################################################
################################################################################################################################
################################################################################################################################
################################################################################################################################
################################################################################################################################
################################################################################################################################
###########################..................###################################################################################
###########################..................###################################################################################
###########################..................###################################################################################
###########################..................###################################################################################
###########################..................###################################################################################
###########################..................###################################################################################
###########################..................###################################################################################
###########################..................###################################################################################
###########################..................###################################################################################
###########################..................###################################################################################
###########################..................###################################################################################
###########################..................###################################################################################
###########################..................###################################################################################
################################################################################################################################
################################################################################################################################
################################################################################################################################
################################################################################################################################
################################################################################################################################
################################################################################################################################
################################################################################################################################
################################################################################################################################
################################################################################################################################
################################################################################################################################
################################################################################################################################
################################################################################################################################
################################################################################################################################
########################################################......##################################################################
########################################################......##################################################################
########################################################......##################################################################
###########################.############################......##################################################################
#######################.........########################......##################################################################
#####################.............######################......##################################################################
####################........E......#####################......##################################################################
###################.................####################......##################################################################
##################...................###################......##################################################################
#################.....................##########################################################################################
#################.....................##########################################################################################
################.......................#########################################################################################
################.......................#########################################################################################
################.......................###################################################################.#####################
################.......................###############################################################.........#################
###############.........................############################################################.............###############
################.......................###################..................#######################...............##############
################................S......###########################################################.................#############
################.......................##########################################################...................############
################.......................##########################################################...................############
#################.....................##########################################################.....................###########
#################.....................##########################################################.....................###########
##################...................###########################################################.....................###########
###################.................############################################################.....................###########
####################...............############################################################.......................##########
#####################.............##############################################################.....................###########
#######################.........################################################################.....................###########
###########################.####################################################################.....................###########
################################################################################################.....................###########
#################################################################################################...................############
#################################################################################################...................############
#######################################################################################.##########.................#############
#######################################################################################.###########...............##############
#######################################################################################.############.............###############
#######################################################################################.##############.........#################
#######################################################################################.##################.#####################
################################################################################################################################
################################################################################################################################
################################################################################################################################
################################################################################################################################
################################################################################################################################
################################################################################################################################
################################################################################################################################
################################################################################################################################
################################################################################################################################
################################################################################################################################
################################################################################################################################
################################################################################################################################
################################################################################################################################
################################################################################################################################
################################################################################################################################
################################################################################################################################
################################################################################################################################
################################################################################################################################
################################################################################################################################
################################################################################################################################
####################..........##################################################################################################
####################..........##################################################################################################
####################..........##################################################################################################
####################..........##################################################################################################
####################..........#########################################################################################........#
####################..........##################################################################################################
####################..........##################################################################################################
####################..........##################################################################################################
####################..........##################################################################################################
################################################################################################################################
################################################################################################################################
################################################################################################################################
################################################################################################################################
################################################################################################################################
################################################################################################################################
################################################################################################################################
################################################################################################################################
################################################################################################################################
################################################################################################################################
