################################################################################################################################
###.#.#################.#.##########.......###.#....................###........#....#.########...............######.......######
#.......#.#.#....####.......######......................................................####..................###..........#####
#.................###.....................................................................##.................####...........####
#.................##.........................................................................................###.............###
#.................###......................................................................................####.............####
#................###......................................................................................####...............###
#................###......................................................................................###................###
#........................................................................................................###..................##
#.............................................................................................................................##
#.............................................................................................................................##
#.............................................................................................................................##
#.............................................................................................................................##
#.............................................................................................................................##
#.................................................................#.........................................................####
#................................................................###.......................................................#####
#..........................................................................................................................#####
#..........S...............................................................................................................#####
##..........................................................................................................................####
#.............................................................................................................................##
##............................................................................................................................##
#...............##.............................................................................................................#
##.............###.............................................................................................................#
#..............###...................................................................................................#.........#
##..............#...................................................................................................###........#
##...................................................................................................................#.........#
##.............................................................................................................................#
##........................##......................................#............................................................#
##.......................###.....................................##............................................................#
##.......................###....................................####...........................................................#
##.......................##.......###............................#.............................................................#
##...............................#####.........................................................................................#
##..............................####.#.........................................................................................#
##..............................###............................................................................................#
##.............................###.............................................................................................#
##................................................................................................................###..........#
##................................................................................................................##...........#
###.................................................................................###........................................#
###................................................................................#####...........##..........................#
##.................................................................................#####...........##..........................#
##.................................................................................####...........##...........................#
#..................................................................................###.............#...........................#
#...................................................................................##.........................................#
#..................................................................................#####.#................................##...#
##..................................................................................#######..............................#######
##.................................................................................#######................................######
##.................................................................................##.#..................................#######
##.................................................................................##.....................................######
##................................................................................##.......................................#####
##................................................................................##......................###...............####
##........................................................................................................##.................###
##............................................................................................................................##
##............................................................................................................................##
#..............................................................................................................................#
#.............................................................................................................................##
#..............................................................................................................................#
#.............................................................................................................................##
#..............................................................................................................................#
#..............................................................................................................................#
#..............................................................................................................................#
#..............................................................................................................................#
#..............................................................................................................................#
#..............................................................................................................................#
#..............................................................................................................................#
#..............................................................................................................................#
##.............................................................................................................................#
##.............................................................................................................................#
##............................................................................................................................##
##............................................................................................................................##
##.............................................................................................................................#
###...........................................................................................................................##
##.............................................................................................................................#
##.................#..........................................................................................................##
#................####..........................................................................................................#
#................####.........................................................................................................##
#..................#...........................................................................................................#
#.............................................................................................................................##
#..............................................................................................................................#
#.............................................................................................................................##
#.............................................................................................................................##
#.............................................................................................................................##
#.............................................................................................................................##
##............................................................................................................................##
#..............................................................................................................................#
##............................................................................................................................##
#..............................................................................................................................#
##............................................................................................................................##
#..............................................................................................................................#
##............................................................................................................................##
##.............................................................................................................................#
##............................................................................................................................##
##............................................................................................................................##
##............................................................................................................................##
##...........................................................................................................................###
##...........................................................................................................................###
###.........................................................................................................................####
###..........................................................................................................................###
####............................................................................................#............................###
####............................................................................................###...........................##
####............................................................................................###...........................##
###...........................................................................................................................##
###...........................................................................................................................##
##............................................................................................................................##
##.............................................................................................................................#
###............................................................................................................................#
####...................................................................................................##......................#
#####................................................................................................###.......................#
######..................................................................................##...........###.......................#
####.....................................................................................##....................................#
####...........................................................................................................................#
###............................................................................................................................#
###............................................................................................................................#
###..................................................................................................................###......##
##....................................................................................................................##......##
##...........................................................................................................................###
#...........##................................................................................................................##
##..........###...............................................................................................................##
#............#................................................................................................................##
##...........................................................................###...............................................#
##..........................................................................###...............................................##
###.........................................................................###................................................#
####...........................................................................................................................#
#####......................................................E...................................................................#
######.........................................................................................................................#
#######............##.................................................................................#.......................##
########..........#####.....#......................................................................######....................###
#########........######.#.#####.......#.#.#.#.#.#.####.#.#.#######.#.#.#.#.#..#.................###########................#####
################################################################################################################################
