################################################################################################################################
########################################.....................................................................................###
#####...##....#########################.....#####...####################..........#################################...........##
####............######################......####.....#############....................##########.....#######.#####............##
###..............####################.......####.....############......................####.###.........###...####............##
##...............####################.......#####.....##..########.....................####.###..........###..#####..##......###
##................#############...####......#######.......########.....................####.###...........###.##########.....###
##........S........####............####.....########.....#########....................#####.##............###..########......###
##.......##.........##.............####.....#########....#####........................#####.#.............###...######........##
##......####.......................###......#########....####.........................#####.#.....................##..........##
##.......##........................###.......#########.................................####...................................##
##..............###................##........###########................................###...................................##
##..............###...............###.........############....................................................................##
##..............####...............#................#######.........................###........##.............................##
##..............#####................................######.........................###.......####.................###.......###
##...............#####................................#####.........................####.......##.................#####...#.####
##.................##.................................#####..........................####.........................######.##.####
##.....................................................###...............#............###..........................########.####
##..........................................#...........................###............###........######.............######.####
##.........................................###......##..................###............###.......########.....###.....#####.####
##......###...............................####.....####.................###............###.......########....####......####.####
#.......####.............................####......#####................###...........####........#######....####......####.####
#........###.......................##....###........####...###.........####...........####........#######.....##.......####..###
#........###......................##########.........##....###........#####............##.........######..............####....##
##........###....................###########...............##........#####........................#####...............####....##
####......###....................###########.......................######........................####................#####....##
######.....##.....................###..######.....................######..........#..............###.................#####....##
#######.........#........##.............######....................#####..........###..####...............##...........###....###
########.......###....######..............####....................####............#########..............###................####
########........###..#######...............##.....................###.............##########.............####.............#.####
########.........###########.....................................####.............############.............#............###.####
########..........###########.........#..........................####..............############........................####.####
#######....##.....############.......###....................#....######.............############.......................####.####
######....####...###...#######.......####..................###...#######............#####....###.......................####..###
####......#########.....######........####................##############...........#####......##.......................###....##
###......##########......####..........###.......###......#############...........######......##.......................###....##
####....###########.......##....................#####.....############............######......###.....................####....##
#####..#####...#####...........................######......###########.....###.....#####......###.....................####...###
###########....#####...........................#######......####..###.....#####....####......#####...................#####...###
##########....######..........###.............########......###...........#####....###........#####.................######...###
##...####.....#####..........#####.....###...##########.....###............#####...##............###................######..####
#..............#..........#########...####...###########...###..............####...##.............###....#..........############
#.............#..........###########..####..##################...............##....##.............###...###..........###########
#......###...###..........##########..####..########...#######....................###............####...###...........##########
##.....#############.......#########...###..########...#######...................####...........####.....#.............#########
##......#############.......#########.####..########...#######..................######.........####....................#########
##.......######..#####......##############...#######...#######................########........####....................#####..###
##........##......#####......##..##########....####...########...............####...##........###.....................###....###
#...###............#####..........##########.........#####.................#####..............##................##...........###
#...###............######.........###########.......#####.................####...............##................####.........####
##.................########.......###########......######................####....###...................###.....####.........####
##.................###########.....##########...#########................####...#####...........................##..........####
##..................##...######.....#########..#########..................###...#####................####...................####
#.........................####.......#######...#####................####.####....#####...............####...................####
#....................................######....####................#########.....###########.........###.....................###
##..................................#####.....#####................#########.....############.................................##
##.......##.........................####.....######................########.......##############..............................##
##......####.........#########.......##.....########...............#######........###############.....................#.......##
##.....#####........############...........##########..............#######..........####...#######...................###.....###
##....#####.........######...####..........#################.......#######...........###....##########...............###....####
##...######..........#####....####.........##################......#######..##.......###....###########...............##....####
##...#######..........####....#####.........#################.......###########......###.....####..####......................###
############............#.....######...........#########..####.......##########......##.......##....####......................##
#######...###..................######..........####........#######....########......##..............####......................##
#####......##..................######.........####..........#######....###......######.............#####......................##
####.......##.................#######........####............######............######..............####......................###
###.......####.............##########........###.................#..............##................####.......................###
###.......####............###########........##..................................................####.......................####
###.......####......###..######..####....................###.....................................###........................####
###........####.....#########.....###....................###.......###...........................##.....####.................###
###.........####.....#######......####....................#.......#####...........##...................##########............###
###.........####.....######.......#####...........................#####..........####..................###########...........###
###..........##......#####.........######..........................###...........#####................#############.........####
##..................#####...#.......######........................................#####..............###############.......#####
#................#######...###.......######........................................#####............#########..#####.......#####
#...............#######...####........#####......##.................................####............####..##....###........#####
##..............######...####..........###.......##.................................#####...........###.........##.........#####
##.............#####.....###.....................##.....#####.......................#####...........###.........##.........#####
##.............####......####..###.....................#######......................######..........####........###.......######
##...##........####.......########.....................#######..............#.......######..........######......#####....#######
##..####.......#####......#######..........##...........######...###.......###.........##...........#######......#####..########
##..####.......#######...#######...........###...........####....###........#......................########........#############
##...####......###############.............####...........##.....###...............................#######..........############
##....######...############.................###..................###................................#####..........#############
##....#######...##########...................###....###.........####..................................##..........#####...######
##.....######......#######....................###...###.........####.............................................#####.....#####
##......####..........####.....................##...##.........#####......##.....................................#####.......###
##......####...........##......................##...##.........#####.....####....................#####..........#######.......##
##......####..................#...............###...##........######.....####...................#######........#########......##
##....#######...............####..............###....##.......#######.....##....................########......##########......##
##...#########...........########.............###....###.....########............................########..#############......##
##...#########..........##############........####...####...#########..............................#####################.....###
##.....#######...........##############........###...################........##.....................#############..######....###
##......#####.............###...#######.........##....###########..##.......####....................############....#####.....##
###......####....................#####..........##.....##########........###########...............#########.........###......##
####.....####.....................###...........###.....##########......#############....###.......########..................###
####.....###......................###...........#####....#########......#############...#####.......######..................####
####.....###......................###...........######....########.......######.#####...#####..........##..................#####
###......###......................###..........#######....########........##.....###.....###...............................#####
##.......##.......................####....#....#######....########................#.........................................####
##......###.........##.............###...###....#######..##########..............................##..........................###
##.....####........####.............#....###.......#################...#.........................##.................##.......###
##.....####.......#####...................##........################..##........................###...E.............###......###
##....######.....######..............................###############...........##...............###.................####....####
##....#######...########..............................###.....#######.........####........###.........................#.....####
##...#####################.....................................######..........####..##..#####..............................####
##...##############..######.....................................######...........##############..............................###
##..#####..#######....#####.......................................####............##############..............................##
#...####..............######..........##...........................##.......##.....#######..#####..............................#
#....##...............########......#####......###........................#####....######....####..............................#
#......................#..#####..#########..######......................#######....#####.......................###.............#
##.........................######################.....................#########....#####.......................###......#......#
###.........................##################........................#########....#####.......................###.....##.....##
####............................###########...................###.....########......####.......................###......#....###
####.............................###..####....................###.......###..........##........................###...........###
###..................####..............##.....................##...............................................####..........###
###.................######......................##................................##......................###..#######........##
####................######.....................####..............................####...##...............####...##########....##
#######..............######....................####..............................####..####........##########....##########...##
########...............#######.................####..............................###...####........##########......#######....##
########................######.................###......................................##.........###########................##
###..##..................#####.................###.................................................###########................##
##.......................#####................#####................................................############...............##
##......................######................######.................##...........................#############...............##
##.....................#########.....##.......#######...............####..........................##############........##....##
###.....###...........###########...####......########......#############...........###...........################.....####...##
############......#######################....################################......########......###############################
################################################################################################################################
