################################################################################################################################
######...................#############################..########################################...#############################
######....................#####################...###....################....###############..........###########..#############
###..#.....................####.##############.....#.....###############.....####.....###...............########.............###
##..........................##...####....#####............########..###......###.........................######...............##
##.......................................#####.............######...........####..........................####................##
##..................####..................####.............######...........###...........................####........###.....##
##.................######..................###..............#####...........##..................###......#####........####.....#
###...............##########...............####...............###...............................###.....#######.......#####....#
#####.............###########..............####................###..####.......................###......########.......####....#
######...........############...#...........##.................##########....................#####......#########.......##.....#
######..........############...##.............................############..................######.......#######...............#
#####..........############.....#............................############.............###...######........#####...............##
####...........####...####.............##...................############.............####...#####.............................##
####..........###......##.............####.................#######..###.............#####...####.............................###
###..........###.....................####.................#######..................######...####............................####
###......#######....................####..................#######.................######....####..#.............#..........#####
###.....#########....................##......##...........#######.................###.......#######............###.........#####
###.....####..####...........................##............######.......####......##........#######............####.........####
###.....##.....####..........................###...........#####.......######...............######..............####.........###
###............####.........................####...........###........########..............######..............#####.........##
###............#####.......................####.............#.........#########..............#####...............####.........##
###.............#####..####...............#####......................#####...###..............###.................##...##.....##
##.................########...............######....##..............######...###......................................####....##
##..................#######..............########...#..............#######....#.......................................#####..###
##............##.....####................#########.................#######............................................##########
##...#.#.....####.....##..................########..................#####............................................###########
######.##.....###..........................######....................#####...............................#..........#######.####
######.####.................................####......................#####...................##.........##.........######...###
######.#####...............##.......###......##.......................######.................####........#...........#####...###
######.#####..............####....#####................................######................####............................###
######..####.............#####....#####..........................##......#####................##..............................##
#####....###......#......#####...................##...............##......######...............................................#
#####....###.....###....######..................###...............##.......#####...............................................#
######...###....#####...#######..........##.....##...............####........###....................................##........##
#######...##....######...#########......####..............##....#####..............................................####.......##
########..##....#######...########.....#####............############...................................##..........####.......##
#############..#########...#######....#####............#############..................................####.........###........##
#############..#########....####......####...........##############...................................####........####........##
####...######..########.....###........##...........############..............................###......##........####.........##
###.....#####..######.......##.....................############...............................####..........#########.........##
###........##...####........##.....................############...............................####.......#############........##
###..............###........##......###............########......................#...........######....###############........##
####.............####.......##.....#######....#.....######......................###.........#####################..####.......##
####.............####......###....#########..###.....#####......................###.........##############.#####....###......###
####.............###.......####..##########...#........####......................###........#############...####.....#......####
###..............###.......########...####..............###......................####.......######..####....###............#####
##..............####.......#######......................####....................######......#####....##......#............######
##........###..#####......########.......................####....##...........########.......###...........................#####
##......#############....#########........................###...####.........########........................................###
##.....###############..##########.........................##...####.........#######.....#....................................##
###...############################...............................##..........######......##....................................#
############.......#####..########...........................................#####..............................##.............#
###########................########.........##................................####.............................####............#
###########.................#######........###.................................##..................########....####...........##
###....#####.........##.........##........###.....................................................##########...####..........###
##......####........###...................###.........#...........................................##########....###..........###
##.......##.........###...................##..........####.........................................#########....###...........##
##...................#....................##............##.......##.........................##......########....###............#
###......................................###.....##.............####................###....####......######....####....##......#
###.......##..........................#######...####............####..............######..#####......#####..########..####....##
##........###........................########..#####...........######............#############.......#####.################..###
##........###................###.....########..####...........#########..........############........###########################
##.........#................#####....########...##.......##..###########.........############.......##########...#######...#####
##..........................######..#########....S......################.........############.......#########.....#####.....####
##.........................##################...........#########..#####.........####.....####......########......#####......###
###........................##################...........#######.....####..........##........###......#######.......####.......##
####.......................########....######...........######......####.....................#####.....####.........##........##
######......................######......#####............###.........##..............###......#####.....##....................##
#######.......................####......#####.......................................#####.....######...........................#
#######........................####.....####........................................#####......######.........###..............#
######.........................#####.....##.........................................####..........####........#######.........##
#####..........................#####..........##....................................####............#........##########.......##
#####..........................####..........####..................................####.....................############......##
#####..........................###............###.................................#####.....###............#######..######....##
#####.........#.................#..............#..................................#####.....###......###...######....#######..##
####.........###..................................................................#####....####...#######...####.........####..#
###.........................................................##....................#####....####...########................###..#
##..................##.....................................####.........###......#######....###....#########...............#...#
##.................####...............###...................###.........####....########....###.....#########.................##
##.................####..............######......###........###.........####....#######......#.......####.####...............###
##..................###.............#######.....#####.......###........#####.....##..................###...####..............###
###..................###............####........#####.......###.......######........................###....####...............##
###..........##......####......#.....#...........###.........#........#######......................###....#####....##..........#
####........####.....####.....###......................................#..###.....##.......##...####......####....####.........#
####........#####....#####....###..........................................###..#####......########......####.....####........##
####.........#####....###......##...........................................#########......#######......#####.....####........##
###..........#####.............##...........................................#########.......###.........######.....###........##
##............###..............##............................................#######........##.........#######................##
#......###.....................###...............................##............###..........###........######..................#
#......###.............##......####.............................####...................########.......######...................#
#.....####......###########.....####............................####..................#########.......#####....................#
#.....####.....#############.....#####...........................###.......####.......#########......######........#...........#
#....######.....##.....######......####...................................######......#########......#####........##...........#
#...########............#####.......####..................................######......########.......#####.........#..........##
##..########............######.......#####.................................#####.......######.........###.....................##
##...#######............#######.......######................................####........####..........##......................##
##....######.............########.....#######................................###.........###.........###......................##
###....####........##.....########.....#######................###............####.##.....####........###......................##
###....###.....#######.........###.....########........###....####....##.....########....########....###............###......###
###............########.........##.....#########......#####..######..####....#########....#######....###...........#####....####
##..............#######.........##.....#########......####################...#########.....#####.....###...........#####...#####
##..............########........##....####...###.......####################...########.......##......###...........####....#####
##..............########.......###...#####...####......#############.....#.....######...............###.............##......####
######...........#######.......###...#####...######.....###########..............####..............####.......................##
#########..........#####........#.....###....########.....##...####...............##...............###........##..............##
##########..........#####....................#########.........####................................###....#######....##.......##
##..######...........####....................#########........#####.......................................######....#######...##
#....####.............##.....................#####...#........####........................................#####.....#######...##
#...................................####......##...............##...........................................##......####.......#
#..................................######..........................................................................####.......##
##..................................#####..........................................................................####....#####
##....................................##........................................##.................................####...######
###.........................................................................#######...E.......................###...############
####................######........................................###.....#########...............##..........####..############
######.............########......................................######..###########.............####.........####..############
########...........#########.....................................###################.............####.........##################
#########....###...##########...................................##########..#######..............####.........##################
#########....###...##########................###.............############....###................####...........######...########
########......#...###########................###............#######...##........................####............####........####
#######...........###########................###............######.....................###.....####..............##.........####
#####............############................####....##......###.......................###....#####.........................####
####.............###########..................###....#####.............................###....#####.........................####
####.............##########...................###.....#####............................##.....#####........................#####
####.............##########...................####....######..........................###.....######............##.........#####
#########.......##################...........######..########........................####.....#######..##......######.....######
###########...####################################################.....###################...###############..########..########
################################################################################################################################
