################################################################################################################################
##############.......................................................................................#############...#####...###
##############....######################.##................######....#######...###################.....####.#.###.....###.....##
######.######.......####################.##................####......######.....#################.....####....................##
####.....#####......########.#.####......##.................#.........####......#################.....###......................#
###......#####........######.............##...............#.#.......######.......#################...####......................#
##.........#####......#####..............##...........#####.........#####........#########....###########......................#
###........#####.......#####..........##.##..........#######.......######.........#########..############......................#
##...........####........#....#.#.#.####.#............######.......####...............####....########........................##
###..........#####...........##########...............######........#.#.................###..######...........................##
###............###............######...................#####..................................#####..........................###
####...........###..............###....................#######.#......#.....................#######..........................###
####....................................................##########.######....................#######.........................###
#####....................................................##################.#.................#########......................###
####...............................#......................####################...##...........###########...##................##
####..............................####...................###########################............#########...###...............##
###...............................####.#.#................##########################............########...###...........###...#
###................................#.###.##..............#########.#.###############............####.#......##...........##....#
####.................###.....##.#.....##.##..#...........#########.....#.######.#####...........####.......###....###.........##
####................#####..######.....##.##..##..........##...##............#...######..........###.........##.....####.......##
#######.#.###......#####..########...###.##..#..........####.###.................######........#####........###....#####.....###
#############.......####...#######.#####.##..#..........####......................#######.....######........###.......#.....####
############........###...####.#########.##............######......................######.#.####.#.#........##........#......###
############...............##.....######.#.............#####.......................##########.............####........##.....###
###########.........................####...........................................########..............####........###.....###
###########..........................................##....................#.......######................###........#####....###
#########............................................##....................##.....####...................#.#.......######....###
#######............................................####...........................####...........................#########....##
#####........................#...................######..........................###.....................#.#...##########.....##
###..........................##................#########.........................##............###.......################.....##
###..........................###.............#####.#####.......................................###......#################.....##
#.............................###............####....#####.....................................###.......##############.......##
##...............#............####...........##.....######.............##..............####.....##...........##########......###
#...............####..........####...........#.......######...........#####..........######..................##########.....####
##..............#####...#......###........#.........######.............######.......#######....................#######.....#####
##..............####.....#....###.........#..........######............#######......####.#.....................########....#####
###..............#########.....##........##..........#####.......#......######.....#####........................######....######
####..............########.....#......................#####.....################...####..............##.#.#.......######..######
####...............#######............................#####.....################.#####...............######.......##############
#####...............######.............................###......######################.................###..........############
#####...............#####..............................###......#####################..............................#############
######...............####..............................#.........#########.##########........................####...############
######..............#####.............................##..............#.......###.#..........................####...############
#######.............#####..............S....................................................................#####.....##########
######..............#####..................................................................#.#..............###......###########
#######............########....................................#..........................#######...........#.#......###########
######.............##..#####..................................###.........................#######...................############
#######...........##.....####..................................###........................########..................############
######.....................#...................................###..........................######..................############
#######...........##............................................##..........................#######..................###########
######............##...................#.......................###...........................######..................###########
######............###..................#.##...#.................##...........................######....................#########
####..............####.................#.##..####..............###...........................######....................#########
###................###...................##..####...............##...........................######..............#.......#######
###.................#....................##..#####............#####.........................####.##..............#......########
##.......................................#....###.............######........................##...................##......#######
###....................................#.#....#####..........########.......................##...................#......########
##.........#######....................##......#####.#.##.....##########.............###.....##...................##......#######
##.........########...................##.##..############....############..........####.....##...................#......########
##..........#######..................###.###.#############....#############........#####....##...................##.......######
##............####...................###.###.############....##############.......######....###..................#..........####
#...................................####.###.#############...################....#######.........................##.........####
##.................................#####.###.#########.#...#############################.........................##..........###
#..................................#####.###.#########.....#######################.#.#...........................###........####
##.....#..........................######.###.#######.........##########.##########...............................###........####
##....####.........#.............#######.###.##.#.#.............#.#####...#######................................#..........####
####..#####.......##.............#######.###.##....................##.....#####..............................................###
####...####.......##............######.....#.#.......................#......#...........................######...............###
####...###........#.............####.......#.#.......................#..................................######...............###
###............................#####.......#.#.....................#####..........##....................######...............###
###............................###.........#.#.....................#####..........###...................######.............#####
#..........................................#......................#######........####....................#####.............#####
#..........................................#......................#.#.##..........###....................#####.............#####
#................................................................................####................#.....####..............###
#............................................#....................................###...............###.....###...............##
###..........................................####.................................###...............###......###..............##
###.#...................#..............#.....####..................................##...............###......###..............##
#######...............####.............#.....###.....................#.............###...............###.....####.............##
######.................###.............#.#.#.###.................#.#####.................##.#.#.......##.#.######.............##
######................#####............#.###.###.................#.#######.............#########.......###########............##
####..................#####............#.###.###.................#...#####..............#######..........#########.............#
###....##............#######.............###.##.......................#####...............##..............########............##
##......#............########............###.###......................#####.................................#####..............#
#...................##########............##.###......................######..........#.......................#...............##
##...................####.#.####..............##......................#####...........#........................................#
#.............................##......................................#######........####.....................................##
##..........####.............####...................................#########.........#####......##...........................##
#..........#####.............####...................................########..........######.....#...........................###
##........#####.............####..............#.###................#########..........#######..###...........................###
##.......#####.............####...........##.#######...............####.##............############..........................####
##......####..............###............###.###########.##.......###...##............###########...........................####
###....#####.............####............###.##############.......####................############..........................####
###.#.####..............###..............###.##.....########......####...............############...........................####
##########.............####..............###.#......########......####...............#############.........................#####
########................##................##.#.......######......###..................#############.........................####
######................###........##........#.#.......######...........................#############.........................####
####..................###.........##.......#.##.......#####....###....................#############..........................###
###............#########..........###........##......#####.....#...........#..........###########............................###
###...........############.#.................#........####....##.........####.........######.####.............................##
##..........#################................#..........................####..........####.............#.....................###
##...#......##################.............#............................####..........####............###.....................##
#....#################....####............##.#............................#...........####............##.....................###
##...###########.#.#........#............###.#.......................................####..............#.....................###
#....#########...........................###.#####...................................####.......................##...........###
##....######.............................###.######.................................#####......................####..........###
#.....####...............................###.#######.................................###......................#####...........##
##....###................................###.#######................................####......................####............##
#......#.................................###.#.#####.......##.#............#.........###.....................#####............##
##........................####...........###.#............#####...........####.....#####.....................####............###
#................####...########.......#.###..............#####..........#######...#####.........##...........#........#########
##.............###################.#.#.#.###.#.....................................#####.........####..................#########
##...........######.#.##################.###.##....................................####.........#####...................########
##..###....#####......#####.#.##########.....##......................................##..........######...................######
#....##.................#.....########.......##..................................#.#.#...........#######....................####
##...####......................#####.........#...................................#####............###.#####.#...............####
#.....##.......................###...........##..................................####...................#######..............###
##...####......................####..........##..................................#####..................########.............###
####...........................###.........#.##..................................#####....................#####..............###
######.........................####........#.###..................................#.##....................#####.............E###
####...........................####.......##.####...........................................................#................###
####............#...............###........#.#####..........................................................................####
###............####.............###.......##.########.##.......................#............................................####
###...........######.............##.......##.##########........................###................................##........####
##............#####..............##.......##.######.###.........................###.#.#.#.#.#.#...........#......######......###
###..........#######......#......##.....##.....####............................################.........######..########....####
###......#.#.#######.#.######...#####...###...####...###.........##.#.#.##....###################.....####################...###
#####################################.#####.#.######.###.......###########################################################.#####
################################################################################################################################
