################################################################################################################################
###.........................................................................................................................####
##......##.........######..............#######...##########.....########............#####################################...####
#.......#...........####................#####.....#####..........######..............###.###################....######......####
#...................####.................###......####............####................#...###############........####.......####
#...................#####................###.......###.............##......................#############.........####.......####
##...................####.....#####.......##........##........................................###...#####........####........###
##....................##.....#######......##.........................................................######.....#####.........##
##..........................########.....####....................##...................................######....####..........##
###............##...........#########....###....................####..................................#######....##...........##
####...........##..........###########..####.........#..........####..................................#######.................##
####..........###.........###....###########.#......###..........##...................................#######.................##
####........#####........###......##########.#########..........................#.......###...........####....................##
###........######........###.......#########.########...............##.........###......####...........##.....................##
##........########.......###.........#####...#######..............#####.......####......####........................###.......##
##........#########.......##..........###....#####...............######......####........##................#........##........##
###......###########......##..................###................#####......####..........................###......###.........#
###.....############.....###....................................####......######.................#........####....###..........#
####....#############....##.....###.............................###......#######................###........##########..........#
#######.##############...###..######...........................###......########.................##.........#########.........##
#######.##############...###########..........##.....###......####......#######.............................#########.........##
#######.##############....##########.........####...####.....#####.......#####..............................#########........###
#######.#############.....##########.....###.###....###......#####.........................................#########.........###
#######.....#########......##..#####....####.###....###......#####............................##..........#########..........###
######.......#########..........####....####.###....###......####........................########.........########...........###
###.............########........#####...####.####...###......###.........#..............#########.........#######.............##
###..............########.......############.#####...#......####........######..........########..........#####................#
###..............########........###########.#####.........######.......#######..........######..........#####.................#
####...####.....#########.............############.........######.......#######...........####..........#######................#
############...####...##.................#########..........####........######............####.........########................#
##################..........................#####............###........######............####........##########...............#
##################...........................###..............##.........#####......##....####........##########...............#
######...#########........##.................###..........................####.....###....###.........##########...............#
####.............##......###.................####..##......................##.......##....###........###########...............#
###...............##....####................##########...................................#####.......###########...............#
##................##....####................##########..................................#########....##########................#
##......................#####................##..####.......##..........................##########....#######..........###.....#
#........................#####.............................####...#......................###########...................###....##
#.........................#####............................####..###.......................##########..................###....##
#..........................#####..........................####...###........................##########..................#.....##
#...................##......####...................###...###.....###........................##########........................##
##.................####.....####..................#########......###.....#...................########.........................##
##...............S..##.......##..................###..#####......####...######....................##..........................##
###.............................................###....####......####....######................................................#
####......................................##...###.....####...............#####.......##...............##......................#
#####...................................#########......#####...............###.......####.............####....................##
#####..............###.................##########......#####.........................####.............####....................##
####..............#####................##########......#####.........................####.............#####...................##
###...............######...............##########.......###....######.................###..............#####..................##
###................#####................####...#..............########..................................#####.................##
###...........##...#####......................................#######............###.....................#####................##
##..........###########.......................................#######...........#####.....................#####...............##
#.......###############........................................##..............######......................####...............##
#....##################.......................................................#######......................####...............##
##..###################..................#...................................#######.......................###...........#....##
###########.###########.........####.....####.............................#########........................##...........##....##
##########....#########.........#####....#####...........................#########.........................##............#...###
##########.....########.........######..######..........................####..####...............###.........................###
###########.....########.........#############.........................####....##...............#####.......................####
############.....############....#########............................####.....................#######......................####
###...######..........########...########............................#####....................########......................####
##.....######..........#######...#######............................######....................#######.......................####
##.....##########......################...........##...............######...###...............######........................####
###...############......##..########...........######..............####.....###...##.........#####.....................###..####
###...#############..........######...........#######..............##............###.........####...................#######.####
##....####.....#####..........#####...........########.............#.............###.........###...................########.####
##....###.......####...........####............#######...##.......#..............###..........#...................#########.####
###....#.........####...........##.................##...###......................###..............................#########.####
####..............##....................................###......................###.................##..................##.####
####....................................................###..........##..........###................####..................#.####
###.............................##......................###..........###..........#................#####.....##..............###
###.............................##......................###..........####........................#######.....###..............##
###.....................................................####..........###....................############....###..............##
###.....................................................#####...............................##############...................###
###..........#.............................##.....##.....####...............................##############..................####
#######.....###...........................####....##.......................................###############................#.####
#######......###..........................####...###.......................................##############.................#.####
######........###..........................##...####........................................#########..............#......#.####
#####............................................##.........................................#######...............###.....#.####
#####.......................................................................................#######...............###....##.####
####......................##..........####........................................#..........######...............###....##...##
###.......................###.....#########......................................###..........########....................#....#
###...............##......###....##########......###......................#......###...........########........................#
####.............####............###..#####......###.....................###.....###...........########.......................##
######...........#####...........##....####......##......................###.....##.............######........................##
#########........######..........##....#####.............................###....###...............####........................##
#############....#######........###.....####............................###.....###.........###....###.......................###
##############...#######.....######.......#.............##.............####.....####.......#####....##......................####
#####..#################....######......................##............######.....####......#####............................####
####.....###############....####........................###...........#######....#####......###...........................#.####
###.........######...........##.........................######........########....####....................................#.####
##...........####.....................##.....#.........########..##....########....###....................................#.####
#.............##.....................####...###........#############........####..###.......................................####
#....................................###########........#############.......########.......###......##.......###.............###
#..........................###........##########.........############.......#######.......#####....####......###..............##
#................##........###.........#########.........##.......###......#######........#####...######.....####..............#
#...............#######....####........#########........###........###....######..........#####...#######....#####.............#
##.............########....####.......#########.........###........####...#####......##..######....#######..######.............#
###............########.....##.......#########...........#.........####....####.....###########.....##############............##
###.............#####................#########....................####......##.....###########........#############...........##
####.............###.................###..####....................###............############..........############...........##
####.............###.......................####..............##.................####...#####...........#######...##...........##
####.............####......................####.............####................###....................######................###
###...##........#####......................####............#####........................................#####................###
###..####.......######.....................####............#####........................................####.................###
##...#####......######.....................###............######.........................................##.......##.........###
##...#####......#######........##........................#######...........##....................................####.........##
##...#####.......#########....####.......................##..##............##.................................#######.........##
##...####.........#########...####.........................................##.........................##.....###..##..........##
###.#####..........########...###....................................................................####...###..............###
########............##..##....###...........................................................#####.....########...............###
########......................###......................................######...............######....######.................###
#########....................####.....................................########................####.....##....................###
#########...................#####........#.............###............#########................##......##.....###............###
######..####................#####.......###.........#######............#######.........................##....#####........#.####
#####.....###....##.........####...#....###........########.............#####..........................#.....######......##.####
#####......##...####.........##...###..###........##########...##......................................E....########....###.####
#####...........####..............##...##.........###############...........................###.............###############..###
#####............##...............#...###........################...........................###.............##############....##
###..............................#....###.......#################.....####..................##..............##############....##
###...................................###.......################......####..................##..............#############.....##
####...................................#....#..##########...###........##..................###.........##....############.....##
#########..................................#############.................................######.......####....###########.....##
##########.........#######.................############.................................##########....####.....###########...###
##########........#########.......###......###########.........#####..###....####.......###########...####......################
###########......###########.....#####....#############.......####################.....#############.#####......################
##############################..###########################################################################....#################
################################################################################################################################
