################################################################################################################################
#########......................#########............################....#################......#################################
#####................#####.....#####...................###.#######..........############.........#############.#.###############
#####................#####......####...................#....#######..........###########.........############......#############
#####..................####....###...........................#####...........###########...........#.#.#####........############
#######................####....###...........#...............######..........##########................#####........############
#########...............##########.......#.####..............#####...........###########................####........############
########................##########......#######......##.......#####..........###...####.................####.......#####.#######
#######...................#######.......########.....##.......#####..........#.....####.......#..........##.......####...#######
######............#.......#######.......########.#.######......####..................#......#####.................####.....#####
#####...........####........###..........################......####........................#######.................#.......#####
####..........###.##.........##..........###.############.......###.........................######.........................#####
###..........##...##.........#............#...##########.......####..................#......#######........................#####
##...........###...#...........................#######..........####.................##......#.####........................#####
#............#..................................####...........#####.............................###.......##..............#####
#................###...........................................######............................###......####.............#####
#..............................................................######.....................................####.............#####
#..............................................................#####.......................................#..............######
#..........................##...................................##.........................................................#####
##........................####....................................................................##.......................#####
##........................####..........................................................###.......####......................####
###......................######.............................................##...........###......####.....................#####
##........................#####....................#.......................###............###.#...#.##.........####.........####
###.....................######.....................###.....................####.............###.............#######..........###
##...................#########.......................#.....................######.............##..........###########.........##
###.................#########...............................................######............##...........############.......##
####........##.....#########........................................###......######...........###............##.#.#######......#
####........##.....######.................................###.......###.......#####...........###.................########....##
#####.......##.....######...............................#####.......###.......######.......#.#.###.................####.##....##
#####........###.######.................................######......##.........####......###...#..................####.......###
###...........#######..................................#######................#####.......##......................####........##
#...............###...........S........................######................#####.......#........#..............#####........##
##......................................................######...............######......#.#....####.............#####........##
##........................................................#...................####.....#############...............#.#.......###
###..................................#......................###................#####.##############..........................###
###................................####......................###.......####......#.###.#.##########........................#####
###................................####....................##############................#########........................######
###...............................#####....................####......####.................#######............#............######
###...............###.............#####..................####.#......##....................#####.............##............#####
####..............###..............#####...#####........###...#......##....................#####.............##............#####
#####.#.###......###...............#####.#########.......#...........##......................###.............###.............###
##########.......###.....##..........#############...................##......................##..............###.............###
######.#........###......##..........############....................##.......###............................####............###
###.............###......###..........#.########.....................##......###..............................###...........####
###.............##.......##...............######.....................#.......###.......................##....#####.........#####
##..............##.......###..............######.....................#.......###......................####....####....###.######
##.............###.......##................######............................##......##...............##.....######...##########
#..............###.......................########....................#........##...#####.............###.......###....##########
##.....##.....#####..................#.#.########....................#.............####..............##................#########
#.....####....#####...............##############.....................##............###..............####................########
##....###....######..###..........##############.....................###............................###...................######
#.....#......####.....##...............#########.....................##.............................####..................######
##...........####.....###..............########......................................................###..................######
#............##.......###................####.##......................................................###.#................#.###
##....................###................#............................................................###.##.................###
##.....................##...............................................................................#.##...................#
##.....................##..........................................................................##...#.##..................##
##.....................##........................................................................####.....#....................#
##..........................................................................##...................##.......#...................##
##.........................................................#................###...............................................##
##........................................................###...............###..........#.#..................................##
###.......................................................###...............####........#####.............#..............#...###
####................................##....................#.#...............###.........#####............#.............####...##
#####..........#....................#####.#.................................####.........###............####...........###...###
#####..........###............#......#######................................###..........###.............###..........#####...##
######........######........#####....########...............................####........................######........#####.####
######........######.....########.....######................................####........................######........##########
######......########.....##########.########.................................#####.....................#######.........###...###
########....#######........###############..................................######....................######.................###
###################........##############....................................#####...................#######..................##
###################........######.######.....................................###.....................#######.....###.........###
##################.........####...#####.......................................###...................#######.....####..........##
##################........#####.....####......................................###.##................#######.....#####.......####
#############............######.....###.......................................#######..............#######.......###....#.#.####
###########.............########....#####...................................#########..............#######.............#########
###########.............########.....####...................###............######.#.#.............#######................#######
##########.............#########....#######..................####..........#.#.....................#####....................####
##...#####.............#########.....########.........##.....#####.....................###.........###......................####
##.....#................................#####.........###.....####.......................#...................................###
##.........................................###........##.....####...........................................................####
###.........................................##................####.........................................................#####
#####.......................................###..............####......................................##.................######
######.......................................#................####.....................................#.................#######
######.......................................................#####.......................................................#######
####..........................................................####........................#..............................#######
##........................###.................................#####.......................##..............................######
###.......................##...................................###........................##...............................#####
###.........##............###..................................................................................#.............###
#####.......#.............##..................................................................................###............###
######.....................##............................#....................................................###..............#
#######...................####..........................####...................................#..............####............##
#######...................#####.....##..................###....................##.............##..............####............##
######...................#############..................##...................#####............#...............####...........###
#####....................############....................#....................####...........##...............####............##
#####....................##########............................................###...........#.................###...........###
###........###.............######...........................................................#.................####............##
###.......#####.............................#.#............................................###................###.............##
##.........###............................#######.........................................###................###..............##
###........####..........................#########.......................................#####......###.....##................##
###..........##...........................########.....................................######......###.......................###
#####....................................########.....................................########....#####.....................####
#####.....................................##...........................................#######....####..............#.#..#.#####
###........................##............................................................####.....#####............#############
##.................###.....##.......................................................................###............#############
##.................##.....###............................#............................................#..............###########
##.................###...####...........................###...............#..................................................###
##..................##.#.####.......................########.............##..................................................###
###................##########......................###########.........######.................#...............................##
##..................#########......................#########.#........#######................####.............###.............##
##..................##########......................#######...........########..............#####............######...........##
#....................#########......................#####.............########..............#####...........#########.........##
##.....................#.######.....................###.................#######..............###........###############.......##
#..........................#####...................###....................#####..............###.......#################......##
##.........................#######..........................................###...............####.....##################.....##
#...........................#######..........................................##...............######..........######...........#
##..........................#######...........................................#................#####.#..........###............#
#............................#######..........................................................########..........###............#
##...........................######..........#................................................########.........................#
##...............#.#.##........####.........####............##...............................####.#.#............###...........#
###.............########......####............###............##..........E...................###...........###.#.###...........#
###..............#######.......###..........................##..............................###............##########..........#
###..............########....................................##..............................#............##########..........##
##................#...###...................................###.....................###....................#########....########
##....................####..................................#####.................######...................#########.....#######
#.....................#####................................######...........#.#.########............##.....#########....########
###.#..............#########.........#######...........############.......##############..........######..###########.#.########
#######.......###############......################################.#.#.##################.#......##############################
################################################################################################################################
