################################################################################################################################
################################################################################################################################
################################################################################################################################
################################################################################################################################
################################################################################################################################
################################################################################################################################
################################################################################################################################
################################################################################################################################
################################################################################################################################
################################################################################################################################
################################################################################################################################
################################################################################################################################
################################################################################################################################
################################################################################################################################
################################################################################################################################
################################################################################################################################
###############.################################################################################################################
#.#########.........############################################################################################################
#.#######.............##########################################################################################################
#.######...............#########################################################################################################
#.#####.................########################################################################################################
#.####...................#######################################################################################################
#.###.....................######################################################################################################
#####.....................######################################################################################################
####.......................#####################################################################################################
####.......................#####################################################################################################
####.......................#####################################################################################################
####.......................#####################################################################################################
###.........................####################################################################################################
####.......................#####################################################################################################
####.......................#####################################################################################################
####.......................#####################################################################################################
####.........E.............#####################################################################################################
#####.....................######################################################################################################
#####.....................######################################################################################################
######...................#######################################################################################################
#######.................########################################################################################################
########...............#########################################################################################################
#########.............################################################.................#########################################
###########......S..##################################################.................#########################################
###############.######################################################.................#####################.###################
######################################################################.................#####################.###################
######################################################################.................#####################.###################
######################################################################.................#####################.###################
######################################################################.................#####################.###################
######################################################################.................#####################.###################
######################################################################.................#####################.###################
######################################################################.................#####################.###################
######################################################################.................#####################.###################
######################################################################.................#####################.###################
######################################################################.................#####################.###################
######################################################################.................#####################.###################
######################################################################.................#####################.###################
######################################################################.................#####################.###################
######################################################################.................#####################.###################
######################################################################.................#####################.###################
######################################################################.................#####################.###################
########.#############################################################.................#####################.###################
#####.......################################################################################################.###################
####.........###################################################################################################################
###...........##################################################################################################################
###...........##################################################################################################################
###...........##################################################################################################################
##.............#################################################################################################################
###...........##################################################################################################################
###...........##################################################################################################################
###...........##################################################################################..............##################
####.........###################################################################################..............##################
#####.......####################################################################################..............##################
########.#######################################################################################..............##################
################################################################################################..............##################
################################################################################################..............##################
################################################################################################..............##################
################################################################################################..............##################
################################################################################################..............##################
################################################################################################..............##################
################################################################################################..............##################
################################################################################################..............##################
################################################################################################..............##################
################################################################################################..............##################
################################################################################################..............##################
################################################################################################..............##################
################################################################################################..............##################
################################################################################################################################
################################################################################################################################
################################################################################################################################
################################################################################################################################
################################################################################################################################
################################################################################################################################
################################################################################################################################
#########################################################################################.######################################
#########################################################################################.######################################
#########################################################################################.######################################
#########################################################################################.######################################
#########################################################################################.######################################
#########################################################################################.######################################
#########################################################################################.######################################
#########################################################################################.######################################
#########################################################################################.####...............###################
#########################################################################################.####...............###################
##############################################################################################...............###################
##############################################################################################...............###################
##############################################################################################...............###################
##############################################################################################...............###################
##############################################################################################...............###################
##############################################################################################...............###################
##############################################################################################...............###################
##############################################################################################...............###################
##############################################################################################...............###################
##############################################################################################...............###################
##############################################################################################...............###################
##############################################################################################...............###################
##############################################################################################...............###################
##############################################################################################...............###################
##############################################################################################...............###################
################################################################################################################################
################################################################################################################################
################################################################################################################################
################################################################################################################################
################################################################################################################################
################################################################################################################################
################################################################################################################################
################################################################################################################################
################################################################################################################################
################################################################################################################################
################################################################################################################################
################################################################################################################################
################################################################################################################################
