################################################################################################################################
################............#####....#########.#.#.#.#.#######.....#####.........#.......############################.#.#.######
###..#########.......................######..............###.........#.....................#..........#....########..........###
#......#.#.#..........................#####..............###................................................#######...........##
#...................................#####.................##................................................######.............#
#...................................######...................................................................#####.............#
#.................................#######......................................................................###.............#
#...................................####.........................................................................#.............#
#..............................................................................................................................#
##....................................................................................................#.#......................#
##...................................................................................................#######...................#
##....................................................................................................######...................#
#..................................................................###..................................#####..................#
#........................................................................................................####..................#
#......#...................................................................................................#...................#
##...####.....................................................................................................................##
#########................................................................................................................#######
#########..............................................................................................................#########
########...............................................................................................................##.....##
#####.#................###...........#.......#................................................................................##
###..................######..........###....###............................................####..............##................#
###..................######...........#.....###...........................................####..............##.................#
###.......##........#######................###............................................#.#..................................#
##........###........#####.....................................................................................................#
###.......###........###............................................................................................####.......#
##..................................................................................................................######...###
###..................................................#...............................................................#####.#.###
##.................................................###...............................................................###########
###................................................##..................................................................#.#######
##...............................................####......................................................................#####
###..............................................###........................................................................####
###..........................................................................................................................###
#####.##..................#...............................................#.......###....###..................................##
###....#.......#.........###..........#.................................#####...######.#####.....................#.............#
####...........##.......####.......#####....##........................#########.###########.....#................###..........##
###.....................####......####.....####......................####################.....#####...............###..........#
###.....................###........#.........##....................######################.....######................#.........##
###.....................###..........................................##################......######............................#
##.......................#...........................................#####.######.#.#.........######..........................##
##..S.................................................................####...####............######............................#
##..............................#......................................#......##..............#####.....###....................#
##.............................###............................................................####......#####..................#
#..............................###.............................................................###.....######.#................#
##............................................................................................###......##########..............#
#.................................................................###......................##.........###########..............#
##................................................................####....................#####.......############.............#
#................................................................######...................####.......#############.............#
##................................................................#####...................#.####.....#####....#.#..............#
#.....................................#...........................#####.......................#.....#####.....................##
##..................................#####..........................###..............................#####.....................##
##....................##..........########.........................###..............................#####.............#......###
###...................###........####.#.##..........................##...............................#####..........####....####
##....................###.......###.................................................................######..........###.....####
###...................###......####..................................................................#####.........####.....####
###....................#.......##...................................................................#...............#.......####
###...........................####...........................................................................................###
###...........................###.................................###........................................................###
###............................##.................................####........................................................##
####..........................##...................................####........................##.............................##
####................................................................###........................##.............................##
####........................................#........................##........................##.............................##
####.......................................####...............................................................................##
###.......................................######...............................................................................#
####......................................######..............................................................................##
###......................................########.....................................................................##.......#
####.....................................##.#.###....................................................................##.......##
###...........................................##...............................................................................#
###.......###.................................................................................................................##
##.......####.....................#................................................................#..........................##
##......######...................###...........#..................................................####.......................###
#.......######...................###...........###.............#.#................................#####.#...................####
##.......#####...................#####.........#####.........######.............##................########.................#####
#..........##.....................###............##........########............##.................#######................#######
##................................####....................#######..............##..................##.#..................#######
#..................................#.......................####...............##..........##..............................######
##..........................................................#.................##........####................................####
##..................##..................................................................##..................................####
##..................###.......................................................................................................##
###..................#...........................................##..........................................................###
###.......................................................#.......##..........................................................##
###......................................................####.................................................................##
###........................................................##.........................................................E.......##
#####.........#...............................................................................................................##
#####........###.............................................................................#................................##
######.......##............................................................................####...............................##
#######.......#.............................................................................##...............................###
#######.......................................................................................................................##
#######.......................................................................................................................##
#######.......................................................................................................................##
######.........................................................................................................................#
#.####........................................................................................................................##
#.###..........................................................................................................................#
#....................................................#.............................................#..........................##
#..........................................#........####.........................................###..........................##
#...........................#.#............#........#####....................................................................###
#..........................#####.........###.........####...................................................................####
#..#........................###........####..........###...................................................................#####
#.####.................................####............##.............................................................#...######
#.####..............................................................................................................############
#.#####............................................................................................................#######.#.###
#.####..............................................................................................................######...###
#######.............................................................................................................#####.....##
##..###...............................................................................................................####....##
##..###............................................#..................................................................####....##
##................................................##..................................................................####.....#
#...........................##....................##....................................................................#.....##
##..........................#.....................#...................................................##.......................#
#...............................................................#.....................................#.......................##
#..............................................................####...................................#........................#
#.............................................##...............####...............................#####.......................##
#............................................###.................##...............................#####........................#
##.........................................#####......#.........................................#######.......................##
#........................................#####.......###........................................######........................##
##.....................................#######................................................########........................##
##.....................................#######..............................................#####.............................##
###....................................#######.............................................####................................#
##.......................................#####.................................................................................#
##.........................................###.................................................................................#
#..............................................................................................................................#
#..............................................................................................................................#
#........................................................................................###...................................#
#.......................................................................................###...................###..............#
#......................................................................................................#.......##..............#
##...............................................................##.....................#.............####....####.............#
###.............................................................#####...................#.......###.#######....###............##
####..............................................#######.......######.#.#.#..........#####.....###########...#####..........###
#####.#.#.#.##...............#.#.####.#.#.#.#.#############.#.#################.#.#.#.#######.###############.#####..........###
################################################################################################################################
