################################################################################################################################
##....................#.#.######.#......#.#.#....#.#.#####.#.#....................#####....#..........#........#.###.....#.#####
##.........................###.#..........#..........#.#.#..........................#............................#..#......##.##
#...................................................................................................................#..........#
#..............................................................................................................................#
#..............................................................................................................................#
#..................................................................................................##..........................#
#.....................................................................................................#.#......................#
#....................................................................................................#####.....................#
#............................................#.......................................................#.###.....................#
#........................................................................................................#.....................#
#............................................##.#..#...........................................................................#
###...........................................#####............................................................................#
###...........................................######...........................................................................#
###............................................###.............................................................................#
####...........................................#..#.......................####.................................................#
###..............................................#...........##..................#.............................................#
###............................................................#................###............................................#
####.............................................................................####..........................................#
#####...............#.#..........................................................###...........................................#
####.................#............................................................###..........................................#
##.............................................................................................................................#
###...........................................................................................................................##
#..............................................................................................................................#
##...........................................................................................................................###
#............................................................................................................................###
##.............................................................................................................................#
#.............................................................................................................................##
###............................................................................................................................#
#.#...........................................................................................................................##
#.#............................................................................................................................#
#.............................................................................................................................##
#..............................................................................................................................#
##............................................................................................................................##
#..............................................................................................................................#
##............................#................................................................................................#
#............................#..#..............................................................................................#
#.............................###..............................................................................................#
#...........................#.#####............................................................................................#
#............................#####................S............................................................................#
#.............................#.#..............................................................................................#
#...............................#.............................................................................................##
###.........................................................................................................................#.##
###.#........................................................................................................................###
#####...................#...................................................................................................####
######.................#..#..................................................................................................###
#####.#.#.............####....................................................................................................##
##.#...#...............####....................................................................................................#
#.....................#..#....................................................................................................##
##......................#......................................................................................................#
###...........................................................................................................................##
##.#...........................................................................................................................#
##............................................................................................................................##
###............................................................................................................................#
#.............................................................................................................................##
##.............................................................................................................................#
#..............................................................................................................................#
#..............................................................................................................................#
#..............................................................................................................................#
#.............................................................................................................................##
#.............................................................................................................................##
#...............................................#.............................................................................##
#...............................................##.............................................................................#
##.............................................##..............................................................................#
#..............................................................................................................................#
##.............................................................................................................................#
#..................................................................................................#.#.........................#
##.................................................................................................##..........................#
###............................................................................................................................#
##.............................................................................................................................#
##.............................................................................................................................#
#..............................................................................................................................#
##............................................................................................................................##
#...........................................................................................................................####
##............................................................................................................................##
#...........................................................................................................................####
#.................#........................................................................................................#####
#..................#......................................................................................................######
#.................#........................................................................................................#####
#..................##......................................................................................................#####
#..................#......................................................................................................#.####
#...................#.......................................................................................................####
#..................#...............................#..........................................................................##
#................................................##...........................................................................##
#.................................................#............................................................................#
#..................................................#...........................................................................#
#..............................................................................................................................#
#..............................................................................................................................#
#..............................................................................................................................#
#..............................................................................................................................#
#..............................................................................................................................#
#..............................................................................................................................#
##.............................................................................................................................#
##.............................................................................................................................#
##............................................................................##...............................................#
##...........................................................................##................................................#
#.............................................................................##...............................................#
##.............................................................................................................................#
#.............................................................................................................................##
##.............................................................................................................................#
#................................................................................................#.#..........................##
##................................................................................................#............................#
#.....................................................................................#.......................................##
##...................................................................................#.##......................................#
#......................................................................................#.......................................#
##.............................................................................................................................#
#..............................................................................................................................#
##.............................................................................................................................#
#..............................................................................................................................#
##.............................................................................................................................#
#..............................................................................................................................#
##............................................................................................................................##
#..............................................................................................................................#
##.............................................................................................................................#
#..............................................................................................................................#
###............................................................................................................................#
##..................................................................................#..........................................#
####.................................................................................#.........................................#
#####.................................................................................#........................................#
######...............................................................................#.........................................#
######.........................................................................................................................#
##.####.......................................................................................................................##
##.#.#........................................................................................................................##
#....##......................................................................................................................###
#.........................................E..................................................................................###
##............................................................................................................................##
##.#.#.#.#.#.#.#......#....#.......###............................#.#......#.#............#....#..........#.###.#.#......#######
################################################################################################################################
