################################################################################################################################
###........................................................................................................................#####
###..############...#####.#########...........######............#############.....######........#########.....#####.######...###
###...##.....##......###...########............####..............#####.#####.......####..........#######.......###....####....##
###..................###...########.............###..............####...###.........##...........######........###.....###....##
###..........S........#.....######..............###...............##....##........................##..........####.....###....##
###.#............................................##.....................##...................................#####.....###....##
###.###................................................................###...............##..................####.....####....##
###.###.............................####...............................###............######.................####....######...##
###..##...........###..............######....#........................#####..........#######.................####...######....##
##..................##.............#######..###......................########........#######................#####...####......##
##..................###............#######...##.....................##########........######................#####...###.......##
###............##....###..........#######....###....................#########..........####............##....####...###.......##
###...###.....####....#..........#######.....###.....................####...............##............####...####...####......##
###..####....######.............#######......####..............................####..................#####...###....#######..###
###..##############............#######.......#####................##..........#####.................######...###.....###########
##...#############.............#######........####.............######..........####.................#####...####......##########
#....#############.............######.........####............#######...............................#####...####.........###..##
#.....############..............#####.........####............#######...............................######.####................#
##.........#######................###.........####.............#####................##...............####..###....###..........#
##..........######.................#........#####............#.....................####..........................#####.........#
##...........#####.........................####............###.....................#####.........................######........#
###...........###.......###...............#####............####.....................####.........................#######......##
###....................####...............#####............###........##.............##..........................#######....####
###.######.............####................####............###.......####..................##.....................#####.....####
###.######.............####.................####...........###.......#####................####.....................###......####
###.#####..............###....##............####............#.........####..............########............................####
###.####...............###....##...........####........................###.............##########...........................####
###.###................####..###...........###..........................................#..######...........................####
###.###........#.......#########...........................................................#####............................####
###.###.......###.......#########....................###..................................####.................................#
###.####......#####.....##########...................####.....###........................####...............................####
###.####.......#####.....##########....#.............####....#####................##.....####..............................#####
###.####.......######....##########...###............####....#####................###....#####............................######
###...........#######....##########...#####..........###.....####..................#.....#########.......................#######
###...........########....#########....#####................####..........................########..................############
##............#########......#######...#####..............#####...............................###................###############
##......##.....#########......##############.............#####......#......##...................................################
##.....####........######.....###############............####.......##....####..................................####...#########
##.....####.........######...####..################.......##..............#####....................###...........##.....########
##.....####.........############....###############.......................#####...................#####..................#######
##......##...........###########........############......................####.....................####............##.....######
##......................#########........####..######.......###..........####.......................###..........#####....######
##.......................#########..............######..########.......######........................###........#######..#######
###......................#########..............######.#########.....########.........................##########################
###......................#####..###............######..#########....#########.........................##########################
###.###...................###....###...........######...########....##########.......................###########################
###.#########....................###...........#######....######.....#########.......................###########################
###.##########..................###............########....#####......########.......................###########################
###.###########.................###...........###########...###.......#######........................###########################
###....########.................###..........#############............#####............#.............###########################
##......#######.............................#########..###............####.............##............###########################
##......#######.............................########....###...........####.............#..............##########################
###....########..............................######.....#########......##..............................#########################
###########..###..............................####......#########......................................###...#######..##########
##########....######..........................###.......#####.........................................###.....###......#########
###...###......#####.........................####........###..........................................###..............#########
##..........................................####......................................................###.............##########
##..........................................###............................................###.......####............###########
##.........................................###........................##...................####.....######..........############
###........................................##.........................##.......##..........####......#####.........#############
###....####...............###..............##........................###......####.........####.......####........##############
###...#####............######........##....##......................######....#####.........###...................###############
###....####...........########......####...##...................#########....####..........###..................###########..###
###..................####..####....#####...##..................##########...####...............................###########....##
###.................####....####...####....##.................###########...####...............................#########......##
##.............########......##....###....####...............####...........................................#..######........###
##............########............###....######..............###.............#########.....................###..####........####
##............#######.............##.....######.............####.............#########......................#....##........#####
##.............#####.....................##................######...........##########.....................................#####
##...#..........####.......................................######...........#########.......................................####
###.###..........##.......................................######............########...................................#.....###
######....................#................................##................#######..................................###.....##
######...................###..................................................#####..................................####.....##
#####....................####........###............###...............##............................###..............###......##
###........##.............########...####............#...............####....................##.....######...........###......##
##.........###............#########..######..........................####................######.....#######...........###.....##
##.........###......##....#########..#######..........................##..............#########....#########..........####....##
##........#####....####....#######...#######.........................................###########..##########.....##..#####....##
##.......#####.....####......####....######................................###........#####...########.######...#########.....##
##......#####.....######.............####.................................####.................######...#####...#########.....##
##.......###......#######............###..................................####..................#####....###....########.....###
##................########..........###......................##...........####..................######..........######......####
#..................#######..........##......................####...........###.........###......#######..........####......#####
#..................######....####..##........................###....##.....####.......#####.....########...................#####
#..................#####....#########.......####...................####....#####.....######......##########.................####
#.....##...........####.....#########......######..................#####..#######....######......###########.................###
##...####..........####....###########.....########....##..........##############.....####........#########..................###
##....####..........##....############.....#########..#####........########..####.....####........#########...................##
##.....###................######...##.......########..######......####........##.......##........#########....................##
##......###...............#####.............#######..########.....###............................#######..........##.........###
##......###................###..............####.....#########....##..............................#####.....##....##........####
##.........................................####.......########....##...............................####....####..###........####
##..........................................##..........#####....###...............................####...#####..###.........###
##...............................................................###.......##......................####...####...###..........##
###......................##......................................###......###......................####...####...####.........##
#####....................##########..............................###......###.......................##.....##.....####........##
######...................###########.............................###......##.......................................#######....##
######.....................##########.............................###...............................................#######...##
#####.......................#########.......#......................###...............................................######...##
####........................########.......###.....................####..............................................#####....##
###.........................#######......####................##....######.....................###.....#......#.......####.....##
###.........................########....####................####....#####...............###..####....###....###......###......##
####.#.........#####.........##############.........##......#####......##......##.......#########....####....###..............##
#######.......#######..........###########..........###......####.............####......#######.....#####.....###............###
######...##..########...........#########...........###.......###.............####..................#####.....####..........####
#####...#############...........#######..............#.........#.............######..................###.......###.........#####
####....#############...........#####..................................##..#########............................###..##....#####
###.....############...........#####...................................##############.............##.............#######...#####
##.......###...................####........###.........................##############.....##.....####............#######....####
##.......................##.....###........###.........................##############....####....####............######.....####
##......................####....####...................................####.....####.....######..####...........######......####
##...............##....######....###...................................###...............#######..##.......###########......####
###.......##....###....######.....##...................................###.........##....########.........#############.....####
###.......##...####.....####...........................................###........####..#########.........############......####
###............####......##............................................###........###############........##########.........####
###.............##...............................................................################.......##########..........####
###..............................................................................################.......##########.........#####
########......................##................................................#################.......##....####........######
########.....................##########.........................................###########.####...............##.......########
########....................############...##.......##..........................##########...###E....................###########
######......................##################.....###.........................###########....#.....................############
###..........................#################.....####......#######...........##########...........................############
##.............................###############......####....#########.........###########...........................############
##............#####.............##############......#####....########........############...................###.....############
###..........#######...###......###############....######....#########...#################.................#####...#############
#########...#################..###########################..##########################################..########################
################################################################################################################################
