################################################################################################################################
###############....................................................................................................#############
##########........###.......#######..########.....###########..######..................###.........#####...........########..###
#########.........##...............................########.....####...................####.........###............#######....##
#########........###...............................#######......####....................#####.......###............######......#
##########......#####.............................########......#####..............##...#####.......###.............#..........#
##########......#####.............................#######.......########..........##########........####.......................#
###########.....####.............................####...........########....###..##########..........###.......................#
###########.....###..............................###...........#########...##############............####......................#
##...######.....###.............................####........#######.......########..####.............####......................#
##...#####......###............................#####.......#######........#######....##...............##.......................#
##...####.......###...........................##...........#######.........#####...............................................#
##..####.......####........................................#######............................................................##
##..####.......#####....................#...................######.........................................................#####
##..####......#######..................###...................#####........................................................######
##...##....############................###....................###..................................................####...######
##........######.....######.............#.....................#..............................................#####.####....#####
##........#####........####................................................................................#######.####......###
##........#####..........##.........#..............................................###....................########.####.......##
##.........####....................###............................................#####..................#########.....##.....##
###.........###...................###.............................................#####.................#########......####...##
####........###..................###...............................................####.......##.......#########.......#####..##
####........###.................####...................................##...........##........#.......#########.........########
####........###.................#####..................................##............................##########...........######
###..................#.....S....######..................................##..........................############............####
##..................###..........#####..................................###.........................#################........###
#....................##...........###...................................####........................######################....##
#......................................................................#####.........................###########....#######..###
#..................................................................#########...........................######...........########
##................................................................#####..###........#....................###.............#######
##...............................................................####.....###......###.....##............##..............#######
##.........................###................................######......###.............####..........................########
##..................##.....###...................###.........###..........###.............####..................#........#######
##.................###......###...................##.........##...........................###...................##..........####
#..................###.......###..........................................................###.................................##
#.........#........##........####................................###......................###..................................#
##.......###.................####................................#####.....................###.................................#
##........###.................##...................##............######.....................###................................#
##.........#####..................................####............######....................###................................#
##..........#####.................................####....##.......#####................#######...................##..........##
##..........#####.................................###....####.......####........###....########.................#####........###
##...........#####...............................####....#####.......###.......#####...#########.........##....#####.........###
##...........#####...............................####.....####........###.....######...########..........###....##...........###
##............###.......###.....................#####......##..........#......######...#######..........####..................##
##.....###.............####.....................######........................######..#######............##...................##
##.....###............#####.....................#######........................###...####.....................................##
##.....##............#####......................########......................................................................##
##...................####......................##########......###...........................................................###
##............##.....####.....................###########.....#####................................................#.........###
###..........###.....####....................############....#######...............................................##.......####
###.........####......##....................############.....#######........................................................####
###.........####........................########..#####.....########.........................................................###
###........######.......................#######.....##......#######....................###....................................##
###.......#######........................#####...............######..............##....####....................................#
####.....########.........................##..................####.......#.......###....####...................................#
#####....#######.................##...........................###.......###......####....####.................................##
######....#####.................####..........................###........###......####....###.................................##
######.....###..................####..........................####........#.........##....####................................##
#######.....................########..............#...........####...................##...####..............#.................##
#######....................#########.............####..........##....................###..###...............##.................#
#######...................###########............####................................###...##...............#..................#
######....................###########.............###...............................####...##.................................##
###......##...............##########.......#.......................................####......................................###
##.......###..............#####...........###....................................#####......................................####
#.......####...............###.............#....................................#####..............###......................####
#.......###...............................................##.....................##...............#####......................###
#......####..............................................####.....................................#####.......................##
##.....###........................#.....................#####...##.................................####.......................##
###....###................####...###....................#####..####.................................###......................###
###....###...............##########......................###....####...................#............###...............#......###
###......................##########.............................#####.................###.....##...###...............###.....###
##.......................#########..............................#####...............#####....#########..............####......##
##......................##########..............................#####..............######....########..............####........#
##.................#............................................####..............######.....########......##.....####........##
##................##.......................................##...###..............######......##.#####.....####....###......#####
##.................#......................................####...##...........########......##...####....#####.............#####
#....................................#.....................####.###..........########....####....#####..#####..............#####
#.........####.......................##.....................#######.........########....####......###########..............#####
##.....########..............................................######.....##..####.........##.......##########...............#####
###...##########.................................................###...####.......................##########...............#####
#################..........................####..................###...####.......................##########...............#####
#################........................#######.................####...##............................######..............######
##########..####.........................######...............#######..................................#####..............######
##...####................................................##..#######...................................####................#####
#.....##...........................#....................###########....................................####..................###
#.................................###...................#########.....................................####....................##
#.................................####..................#####..........................................##......................#
#........###......................####...................###...................................................................#
#........###.......................##..........................................................................................#
#.........##...................................................................................................................#
#.........###.............###.................................................................................................##
##.........###...........#####................................................................................................##
##.........###..........######.........###...................................................................................###
##..........##..........#####.........#####......................................................................###........####
##......................#####.........#####.....................................................................#####......#####
##....###................#####.........####.....................................................................#####.....######
##...#####...............#######.................................................................................###......######
#.....###...............########......................................................................#####.......##.......#####
#...................############...........................##................................###.....######.......##........####
##.................########.....................###.......###...........................#########.....##..........##.........###
##.................#######....................#####.......###..........................###########................###.........##
###.................######...................######......####...............##..........#####..###................####.........#
######...............#####...................#####.....#####...............###..........####....##.................###.........#
#######...............###.....................####.....####.................##..........###.....#.............................##
#######.......................................#####....###.............................####.....#.............................##
#######........................................#####............................#......#####..................................##
######..........................................####...........................###......####...#..............................##
####.............................................##......###..................####........#....#.............E...............###
###..................###................................#####..................##..............#..........................######
####.................####................##.............#######..........................................................#######
#####...............#####...............####............#########.........................................................######
######.........##....####..............#####.............#########....................###............................#.....#####
#######........###.....................######.............########.............##.....###..........................####.....####
#########.....#####.....................######................####............###..................................###.......###
#####..###..................###...........#####................##..............##.................................####.......###
####...###................######...........#####..................................................................####........##
###....###...............#######...........#####..................................................................#####........#
##.....###..............#######............#####..................................................................#####........#
#.....................#########.............###....................................................................###.........#
#....................###########.......................................................................#.......................#
##...................###########........................................................................##....................##
##..................############...................###..................................................#####..............#####
###................#############...................###........#.........................................######.####.......######
####...............###....#####.....................##......####...........###..........................############......######
#####...........######...............###.....##.....##.....#####......##..####.........................#############......######
######.........#######..............#####...####...###.....######...##########.....................##################....#######
#########.....##########..##.......####################...#####################..##...##########..##############################
################################################################################################################################
