################################################################################################################################
#######...###################......#################################################################################....########
###........######..####..###........#######################################.....##########....###################........#######
##..........####....##........##.....######....########..#################.......########......#################.........#######
##..........####.............####.....####......#####.....####......#####.............##.......#################..........##.###
###..........##..............#####....####.......##........##.......####.......................#################..............##
###..........................#####....####..........................###........##..............##################.............##
###..........................#####...######.........................###.......###...............############...#.......##.....##
###................##........####....######..........................#.......####.................##########..........####...###
##................####.......###.........###.................................###........................####..........##########
##....##.........######......###..........##.............................................................##...........##########
##...####.........##############..........##...S..........##...........................................................#########
##########........###############.......................####............................................................########
##########........#############.......................######............................................................####..##
##########........#############......................######.................................###..........................#.....#
######..##........#############.......................####.................................#####...............................#
#####..............#####...####............................................................#####...............................#
#####..............#####....###............................................................####................................#
#####..............#####.....##.................................##........................#####................................#
#####..............#####............................##.........####.......#...............##.###............##....###.........##
#######............######...........................##..........####.....###..............##.####......##############........###
########...........######........................................####.....#................#.####.....##############.........###
#########.........#######.........................................###......................#.###.....#############...........###
########.......##########....................##...................###........................#......#############......#.....###
#######.......###########...................####.................####...............................####...######....###.....###
######.........##########.....####..........#####................#####..............................###.....######..###.......##
#####...........#########....######.........######..............###########......##....###.........###......###########........#
#####............#.######....#######.......#########...........############.....############.....#####.....############........#
#####...............#####.....#######....#######..###.........####.....####....#############.########......###########.........#
#####...............######.......#####...#####.....##.........#................#############..#####........###..######...###..##
####...............########.......####...####...............###................############....###................####..########
####..............#########........##.....##....................................###########....###................####..########
#####............####..####......................................................##########....####..##...........####..########
#####...........####....##.......................................................##########....########........######....#######
#####.......#######.............................................................###########....########.......######..........##
#####.....########..........................##........................##........##########.....#######.........####............#
####.....########..........................####......................###.........########.......####............##...##........#
##.....######................#.............###.......................###..........####...........##..................##........#
#......###..................###.......................................#......##..####...................###....................#
#......##...................####....................###.....................#########..................#########...............#
#....................##.....####....................###.....................#########..................##########.............##
#...........####....####....####.....................###....................#########...................##########.......###..##
#..........######..######..####......................####..................##########..............##.......#######.....####..##
##........#####################......................#####.................####..#####.....###....####......########....###...##
###......####..###############..............#........#####..................##....#####....####....####......########...####.###
###.......##....#########..##..............###.......######..........................##....####.....####..........##....########
##..............########....................###......#######...........##.............##....###.....####................########
##...............######.....................####....########..........####............###....#.....#####................########
##...........................................###....########.........########........#####.........####..................#######
##....##.....................................##......######.......############.......#####.........###.....................#####
##...####.....................#.............###........###.......#############......#####.........####......##...............###
###.#####............#.......###............###.................#############.......#####.........####.....####...............##
##########....###..####.......#........##...###.................#############.......#####........######....####...............##
###########..##########...............###....##......##........########..............########....#######...####...............##
######################.................##...........####.......########................######....########..####...............##
#####.......#########...............................####......#########..................####.....#######..###................##
#####...............................................#####....###########............................####....#................###
#####................................................####...############...........#...................................##...####
#########.............................##..............##....#############..........##..................................#########
##########............................##.....................#############.........#..................................##########
###########....###............##...............####...........#############............................................##...####
############..#####.........#######...........######...........###############...............................................###
###..##############.........#######...........######...........################...............................................##
##.......#########...............##...........######...........#################..............................................##
##........########.............................#####...........#####........####..........####.................................#
##........#######..............................#####...........####..........###......##############...........................#
##........#######..............................#####..........#####..................################..........................#
##........#######..............................#####..........#####..................################.......##.................#
#.........########.............................#####..........#####..................######.....#####......####................#
#....#....########............................#####...........#####...................#####......####.......###....###.........#
#...###....######..........###...............#####............####......................####.....####..............###.........#
#######...................#####............######..............##....#...................####.....##................##........##
######...........###......#####...........######....................###...................###.......................###......###
#####...........#####......####..........#######...................####.............................................###.....####
#####...........#####....................#######..................####.............................................#####...#####
####............####.....................#######.................#####.............................................#####..######
###...#..........##.......................#####.................######..............................................###...######
##...###..................................####...................#####............................##......................######
###.#####...................................#.....................###.......................#.....###.....................######
#########.........................................................##.......................##.....###....................#######
##########........##........................................................................#......##................###########
###########.......##................................................................................................############
###########........##..............................................................................................#############
###..#####.........##..............##..............................................................................#######.#####
##....####.........###.........#######.....................................###......................................#####...####
##....####.........###........#########.....................###......##...####................#####...................###....###
##....####........#####......####..####....................#####....##########...............########........###.......#.....###
##...#####.......######......###....###...................######....#########................#########......######...........###
##...#####......#######.....####....###.................#######......########................##...###.......#######..........###
##....###........#####......###....................##..####..........##########....###.......#..............#######..........###
##...............###........##....................########..........####################.....................#####......###..###
##..........................##....................########.........#####.################......#........................####..##
###.........................###....................######........######...###############.....###.......................####..##
###.........................####....................####........######.......#####...####....####........####...........####..##
###........................#####...........##...................######........###.....###.....##........######...........##...##
##......................#######...........######................######........###........................#####................##
##....................#######.............######.........###.....####........####.........................###......#..........##
###..................#######......##......######.........###......###.......#####.................................###.........##
####...............########......###.......#####........###.......###......#####.......................##..........##.........##
####....##.........##..........#####.......#####........##.........###.....####.......................####.........##.........##
####...####...................###..........######......###.........####.....##........................####.........##.........##
###....#####.................###............######......#..........####........................####....####........##........###
###.....#####...........##...###..............####.................####.......................######...#####........#.......####
###.....######.........#.########..##..........##..................###.........................#####....####................####
####.....####..........#.#############................................................####.....#.........####................###
####...................#.##############................................................###................####................##
####..................##.################...........##.................................###................#######..............#
####..................##.#################.........#######..............................###...............########.............#
###..................###...#####..#######.........########..............####............###..............#########.............#
###..............#######....#........###.........#########.............######...........####......#.....###...#####.......##..##
###.............########.........................########..............#######..##.......####....###....###...#######....#######
####...........#########..........................######.....##.........###########......####....###...........######.....######
####..........#########.....................................####.........##########.......##......##...........######.......####
####..........########......................................####.........#########................###...........#####........###
###....###.....######......#..............######.......##....##.........##########...............#####..........#####.........##
##.....####.......###.....##.............########.....####..............#########................#####..........#####.........##
##......####..............##............##########....####..............#########................#####...........###...........#
##........####.............##...........##########.....####.............########.................#####..................##.....#
##.........####.............##..........#####...###.....####.............##............................................###.....#
##..........####...#........###...###....####....##......####...##.....................................................##......#
##....###....#######........##########....###............##########...................#.....##.........................##......#
##....###.....##...........############....###..........############.................###...####........................###.....#
##...###...................##############.####..........################.............###...####........................###.....#
##...##....................###################...........################............###....##.........................###.....#
###.###.....................##################............#################..........####..........E..................####....##
########........###.........###################...........###################........#####...........................#####....##
########################################################.#########################..#######..############......############..###
################################################################################################################################
