################################################################################################################################
###########....#####.############################################################################..#############################
###....###......###....##...##......###............##....####....########..####################........#####.........##......###
##..............####......................................##......######....##################..........####..................##
#...............#####.....................................##.......####......###############............###...................##
#...............#######..................................####...................###..#####...............##...................##
#..........#.....#######.............#...................#####........................##......................................##
##........###.......######..........###........###........####...............................................................###
##........###..........####.........###.......#####........####.....#####....................................................###
##.......#####..........#...........###.......#####........####....#######.............................##....................###
##......#######.........###....................###........######..########......................###...######.................###
##......#######........####...............................######..########.....................##############...........##...###
##........######..........##...............................####....######.....#...............###############..........#########
##.........#####.....#######...............................####....######....###..............##############...........#########
##........#######...########..............................#####....######....####.............#############.............##.#####
##......##########..########............................########..#######....#######...........#####...###..................####
##.....###########...#######....................#.......##################..#########...........##.............#...........#####
##......#########......####....................###......############..###############.........................###.........######
###..........####.......##.......##............###.......######..##.......############....................................######
#####..........###..............####..........####........####................########...##...##.........................#######
#####...........#####..........#####.........###..........#####................######...#########........................#######
#####...........######.........#####........###............#####......##........#####...#########........................#######
###.............#######.........####.......###..............####......###.......####.....#########.............##.......########
##........#......#######........####........#...............####......###......#####.....#########..........#####.......###..###
##.......###......######.......#####.......................#####.......###....#####......####..##...........#####.......##....##
##.......###.......#####......######.......................####.........###..######......###................####..............##
##........#........#####......#####.........................##..........##########.......##................####...............##
##..................####......####................##.....................########..........................###................##
###..................##........###......#.........##......................######.................##.........##................##
####........#...................#......###.................................####....###...........###........##........##.....###
####......####........................###.........................................#####..........##.........###......####....###
####.....#####.......................####.........................................######...................####......#####..####
####....######.......................#####............##..####...................#######...................###........##########
####....#######......................######..........#########.....######.......########...........##......###.........#########
#####....##..###......................######..........########....########.....##########.........####..................########
######........##.......................#####...........######......########...###############....#####...................#######
##..#.........###..##..................####.............##..........#############....#########...####.............##.....#######
#..............#######.................####.........................############......##############.............####....#######
#..............#######.................####.........................###########.......#############.............#####....#######
##..............#####..................####......S.................############......####..######...............#####....#######
###..............##.....................##....................#################....#####....###.................######..########
####..................................................##.....##################...######........................################
####................................................#####....####...###########...######..........................##############
#####..............................................########...##.....###########...######..........................#############
######.......................................##..###########.........###########....#####..........................#############
######.........###..........................#########....####.........##########.....###..........................####..########
######........######........................########.......###.............#####.................................####....#######
###...........#######........................#######........#..............#####.................................####.....######
##.............##########.......................####.......................######.................................##......######
##..............##########.............###.......####..##...................####.............###..........................#.####
###.............#####..####.....##.....####.....##########..................................#####.........................#.####
###.....#........###....####...####....#####....###########.................................####............................####
###....###.......###.....###....###.....###......##########.................................####.......###....######........####
####..............##..............................##########....###..........................###.......###############.......###
####..............###..............................##########..#####.............###..........#........################......###
####..............###..............................#####..###########...........#####...................###############.....####
####...............##..............................####.....##########..........######..##..............##############......####
####...............###................##...........#####..........#####.........###########..............############.....#.####
####..............####...............####..........######.........#####.........###########..................######.......#.####
#####..#......#########.....##......#####.......##....###........######.........##########....................####........#.####
#########....##########.....###....#####.......####.............######..........#######.......................####...........###
#########...###########.....####..#####.......#####............######..........#####.........................####.............##
########....############.....########........######...........####...........######.........................#####.............##
#######.....######..######.....####.........###..............####...........#####..........................#####.............###
######.....######....######................###..............#####...........####...................####....####....#.........###
####......######.....######...............###................###.......##..####...................######..####....###........###
###......######.....########..............##..................##......#########..................#############....###........###
###......#####......#########.............##..................##......#########..................#############....###........###
####......####.......########.............##.................###.......#######....................############....###.......####
####......####..........####..............###...............####..........................................###.....####......####
###.......####............................###.............######.....................###.........................######.....####
##.........###............................##.............#######....................####........................########....####
##.........####..........................##..............#######.....................###.......................#########.....###
#..........####....................###..###...............#####.......................#........................#########.....###
#..........#####..................#########................##...##.............................................####..####...####
#..........#####.................##########....................####.............................................##....##########
#....#......####................##########...................######.........................E##........................#########
#...###......##.................####.......................########.........................####.......................#########
#...####.........................##......................#########..........................#####...###...............##########
##...####.........#...................................###########...........................############..............##########
##....###........###.................................#########...............................##########......#####.....#########
##.....###.......###...............###...............########.................##..............#####.........######.........#####
##.....###.......###..............#####.............#########.................#####............####.........######..........####
##......##........###..............#####..........###########.................######...........####.........#####...........####
###.....###........##...............###.........#############.......##............##...........######........###...........#####
###.....####.......###.........................###############.....####........................#######....................######
####.....###........#########..................########################.......................########...................#######
####.................#########........#.........####....###############....................###########..............############
####........##........###########.....##.................##############....................###########....###.......#######.####
###.........##........############.......................##############....................###########...#####......######...###
##.....................###########......................####..########......................#########....######....#######...###
#...........................######.....................####....#######........................######.....######...########...###
#...........................######...........##........###.....######.......##...........................######..#########....##
##...........................#####...........###........#......#####.......###...........................#################....##
###..##.......................####...........####..............######..#######...........................################....###
########......................####............##................#############.......##...................#######............####
#############................#####...............................###########........###..................######.............####
##############.....###...########.....##.........................######..##.........###.........##........####...............###
###############....#############.....####........................#####...............###.......####...............##..........##
##...##########....############......#####........#..............#####................#.........###..............#####........##
#........#######...#######..........#######......###..............#####.........................................#######.......##
#..........######...#####..........#######.........................####................................#################......##
#...........######....##...........#####............................##................................##################......##
#...........#######................####...............................................................############..#####....###
#............######.................##.......................................................###.......##########....#####..####
#.............####..........................................................................####.........#######......##########
#..............###.................................##........................................###......................##########
#...###...........................................####.............................###................................##########
##.####...........................................####.............................###............##...................#########
#######............................................##............................................###......................######
#######..............................#......###......................###.......................####........................#####
########..##.................#......###....#####..........####.......####.....................#####........................#####
#############...............###....###....#######.......#######........###.......###.........#####..........................####
###...#######......................###....########.....########.........#.......#####.......####.........##..................###
##....######.......................###....###...####..#########.................#####........##.........#####.................##
##.....###.........................###....##....###############.................####...................#######................##
#.....................###...........###..##....################.................###.....................######................##
#.............###...#######..........#####....######.#########............................##...............###................##
#........###################..........####....#####...########...........................####...............###...............##
#......################.###...........#####....###...########............................####...............###..............###
#.....################...........##...#####..........#######.............................####..............#####........########
#.....###############...........####...####..........#######.................##...........##..............######.......#########
#.....#############.......##...#####....##...........#######................###........................########........#########
##...#############.......####.######................####.##........##.......###.......................#######.........##########
#################.....##############...............#####..........####.....####............###.......########.##...#############
#################....###############.......#####..#######........######...######......##..#####...##############################
##################..#################..###########################################...###########################################
################################################################################################################################
