################################################################################################################################
########.........#########...####################..########...##################################################################
########..........#######......#######..#######.....######........##############################...########..###....#######..###
#######...........#####.........######.....###......######.........################.###########.....######....#...............##
##................####..........######..............######..........##############...####..###......######.....#..............##
##................####..........#########..........#######...........#############..........#......######.....###.............##
###................##...........#########.........#######.............############................#####.......###.............##
###......###....................####..###........######..........##....##########...............######.........#..............##
###......####...................###..............#####..........####......######...............######.........................##
###....#.####...................###..............#####..........####.......####................###.........##.................##
##....##.###......S..............###...............##............##........####...............###.........####................##
##....##..........................##........##..............................####..............##.........####.................##
##.......................####...............###..............................#####......##...###........###...................##
##............##........######..............###............####...............#####....#########........##....................##
##...........####......########..............##............#####...............#####...##########.............................##
##..........######....##########..............##............###................#####...##########............................###
###........#######....####..####..............##...............................#####....########..........................######
####...#.#########.....##....##...#..........###..............................######......................#####...........######
########.#########................##.........###......##...................########......................#######..........######
########.##########...............#..........###.....###..................########....................##########...........#####
########.###########.........................##.....####...................########..................###########............####
#######...###########..............................#####.......................#######...............###########.............###
######.....##########.............................#######.......................#######..............##########...............##
#####.......#####..##............##..............#########........####...........#####.......#.......####...##.....##.........##
####................##..........####.............#########.......#####.....................####.....####..........###.........##
####................####........####..............#####..........######...................####......####..........#####.......##
####................######......####.......###...................######...................###.......####..........#####........#
###..................######....#####.......###..................####......................###......#####..........####.........#
###...........###.....##############.....#####.................####.............###......###......#####....###.....##.........##
###...........#####.......##########.....#####................#####............#######..####.....#####....#####..............###
####..........######........#######......#####................######.....##....#############....#####.....#####.............####
#####...........######....................#####................######...####....############....####......#####.............####
######............#####....................######...............#####...#####.......#########....###.....#####...............###
######....##........####....................######......##...............####..........#######...####....####.................##
#######..####........####....##...............####.....####...............##............##############....##..................##
########.####....#...####....##....##..........###.....#####..............................#############......................###
########.###....#########....##...####..........#.......####...................................########......................###
########.........########........####....................####............##.....................#######......................###
###...............########......####.....................#####..........####.........................###......###...........####
##................########.....####.........###..........#######........######........................###....#####..........####
##................#######.....######......................#######.......#######.......................####..#######........#####
#.............##########.....########.....#####....####......####........######........................############........#####
#.............##########....##########...#####.....####.......##..........######.........###...........###########..........####
##............##########...##########....#####.....####.....................#####........####..........#########.............###
##................##################......####.....###.......................#####.......####.........########...............###
##.......#..........########...####.......####.....###........................####........####........######................####
##.......#####.......######.....##........###......###.........................##.........######......#####..............#######
##.......######.......####.................#......####............#............##........##########....####.............########
###......#######......####.......................#####...........###...........##.......############....###.............########
####.....#######.......##........................####...........###.........######....########..####.....................#######
#####....#####....................................##...........###..........######...######......##........................#####
######...####..................................................###...........#####...####....................................###
########.####..................................................###............###....###......................................##
########.#####..................................................##.....####.........###.......................................##
########.#..#...................................................##....#####........###.......................................###
###..###.......................................................###....####........###....................................#######
##....##......................................................####....####........###...................................########
##..............................##............................###......##.........###...................................########
###............................#####...............#..........##..................###..................................#########
#####..........................##########.........###.............................####.....................##..........#########
########.##....................##########.........................................#######.................####.........#########
###.####.##.....................#######...........................................########...............#####.........#########
##.....#.#.......................#####..................########...................########..............#####..........########
##.................................##.........###.......###########................########.......##.....######.........########
###..........................................#####.......##########................#######.......####....########........#######
###..........................................######.......#########.................####.........###....##########.........#####
##...........................##..............#######.......#######..............................###.....##########............##
##..........................####.............#######........#####..............................###.....##########..............#
##.........................#####.............########........###.....#####.....................###....##########...............#
##.....#.#................######.............########...............##############.............####..##########...............##
##....##.###..............#######.............#######................##############...........############....................##
##....##.####......##.....#######......#.......######.................##############.......############.......................##
###....#.#####.....#......#######.....###.......####...................##############....#############........................##
###........###............#######....#####.......##.....................########################...###........................##
###........###.............######....######..............................######################....###.........#.............###
##.........###...............####....######...............................####...######..#####.....###........###..##........###
##..........#.................##......####........................................####....###................#########........##
##................................................................................###......#.................#######...........#
##........................................................##....................##............................########........##
##....................................................#######..................###..............................#####.........##
##....................................................#######........###......####...............................###..........##
##.......................................................###...##...#####.....####............................................##
##...................................##########................##########.....####..##........................................##
##................................##############...............###########....#########.......................................##
#................................###############.................#########.....########............###........................##
#.................................#############....##............#########.....#######.............###........................##
##.......................##..........#########....#####..........###..####.....######..............####......................###
##....##................####.........########.....#####.......#####...#####...######................#####.......##..........####
#....###................####.........######........####......#####...##############.................#######....####.........####
#...####...............#####........####...................#######...##############..................#######...####.........####
##..####.............#######.......####..................#########....######.....#....................######...####..........###
##...###............#######........###.................##########.....#####............................#####....##.....##....###
##...##.............####...........###................###########.....######.............................###............##..####
##...................##.............#.................##########......#######............###..............###...........########
##.....................................................#########.......#######...........###...............###..........########
##......................................................##...###...##......##...........###................####.........########
##...........................................................###..####..................###................####..........#######
##............................................................#...#####....................................#####.............###
##................................................###.............######....................................####..............##
###.......###.....................................####.............######...................................#####....##........#
########.#####.....................................####..............#####...................................####...####.......#
########.######.....................................###...............####...................................####...####.......#
########.#######.....................................#................####...................................###.....##.......##
########.########......................................................##....................................###............####
########.###########.............#####....................#####..............................................####...........####
########..###..########.........#######..................#######.............................................####.........E.####
#####...........########.......########...##............########..............................................###............###
####.............########.....########...####...........#######................................................##.............##
####.............#########...########.....####..........######............................##..................................##
####............#####################.......#########....####............................####....###..........................##
####.........#######...###############.......#########...###............................####....####...........................#
#####.......########...###############......##########..###............................####.....####.............###...........#
######......########...#####...#######....###########..####....###....................####.......##.............#####.........##
#######.....#######...###.......#####....########......####....####..###.............####.......................#####.........##
#########..#######...###.........###.....#######.......####.....###########.........#####.......................######........##
##################...###.........###.....######.........###.....############.......######........................######.......##
##...############....####........###.....######................#############.......######.........................######......##
#........######.......##.........###.....######...............##############........####.............##...........######......##
#.........................................#####..............#####..#########.......................####....##.....#####......##
##.........................................####..............####........#####......................#####..####....#####......##
####...........##..........................###.............................#######...................##########....#####......##
####..........####.........................##............................#.#.######..................##########.....######....##
###...........####..............#####.....##............................##.....####...................#########......######...##
##.............##..............#######...###..............##............###.....####..................................######.###
##............................##############.............####............###....####.......####........................#########
###..........................################...........######..........#####..######.....###########.................##########
###############..######.....##################....#############################################################...##############
################################################################################################################################
