################################################################################################################################
####.#.##################.#.#......#.#...........#.#.#.#.###########.....######...............#.#......#####.#.#.#.#.#.###...###
##..............#.#.........................................#.#.##.......................................#....................##
#.............................................................................................................................##
#..............................................................................................................................#
#.............................................................................................................................##
#..............................................................................................................................#
#.............................................................................................................................##
#..............................................................................................................................#
#.............................................................................................................................##
#.............................................................................................................................##
#..............................................................................................................................#
#.............................................................................................................................##
#...............................................................................##................##...........................#
#...............................................................................##................##..........................##
##...........................................S...................................##..............##............................#
##................................................................................................#...........................##
####.#.......................................................................................................#.................#
#######.....................................................................................................###................#
#######......................................................................................................#................##
########.......................................................................................................................#
##..###.......................................................................................................................##
#...........................................................................................##.................................#
#......................................###..................................................###................................#
#.......................................#....................................................#.................................#
#..............................................................................................................................#
##.............................................................................................................................#
#..............................................................................................................................#
##.............................................................................................................................#
#..............................................................................................................................#
###............................................................................................................................#
###......................................###...................................................................................#
###......................................###...................................................................................#
###....................................#####...................................................................................#
##.....................................#####...................................................................................#
#....................................######....................................................................................#
##...................................######....................................................................................#
##..................................######.....................................................................................#
##..................................####.......................................................................................#
###..................................#.........................................................................................#
###............................................................................................................................#
###............................................................................................................................#
####...........................................................................................................................#
#####..........................................................................................................................#
#####..........................................................................................................................#
######.........................................................................................................................#
#####.........................................................................................................................##
#####.........................................................................................................................##
####.........................................................................................................................###
####..........................................................................................................................##
###..........................................................................................................................###
###..........................................................................................................................###
##...........................................................................................................................###
#............................................................................................................................###
#............................................................................................................................###
#............................................................................................................................###
#............................................................................................................................###
#............................................................................................................................###
#.............................................................................................................................##
#........................................................................................#....................................##
#.......................................................................................##.....................................#
#......................................................................................####....................................#
#.......................................................................................##.....................................#
#..............................................................................................................................#
#..............................................................................................................................#
#.........................................#....................................................................................#
##......................................####...................................................................................#
##......................................###....................................................................................#
#......................................###.....................................................................................#
##.............................................................................................................................#
#..............................................................................................................................#
###...........................................................................................................................##
###...........................................................................................................................##
###...........................................................................................................................##
###............................................................................................................................#
##.............................................................................................................................#
##..........................................................................................................##.................#
##..........................................................................................................##.................#
##...........................................................................................................#...............###
###..........................................................................................................#..............####
##....................................................................................................E.....................####
##..........................................................................................................................####
#............................................................................................................................###
#............................................................................................................................###
#.............................................................................................................................##
#.............................................................................................................................##
#.............##....................................................................................##.........................#
#.............###...................................................................................##.........................#
#..............##...................................................................................###........................#
##...................................................................................................#.........................#
#....................................................................................................##........................#
#..............................................................................................................................#
#..............................................................................................................................#
#..............................................................................................................................#
#..............................................................................................................................#
#..............................................................................................................................#
#.............................................................................................................................##
#.............................................................................................................................##
#.............................................................................................................................##
#..............................................................................................................................#
#..............................................................................................................................#
#....................................#.........................................................................................#
#....................................##........................................................................................#
#..............................................................................................................................#
#..............................................................................................................................#
##.............................................................................................................................#
##.............................................................................................................................#
##.............................................................................................................................#
###............................................................................................................................#
##.............................................................................................................................#
##.............................................................................................................................#
#..............................................................................................................................#
#..............................................................................................................................#
#.............................................................................................................................##
#..............................................................................................................................#
#.....................................#.......................................................................................##
#...................................#####......................................................................................#
#...................................######....................................................................................##
#.....................................####....................................................................................##
#.............................................................................................................................##
#............................................................................................................................###
#............................................................................................................................###
#...........................................................................................................................####
#...........................................................................................................................####
##...............................................#..........................................................................####
##.............................................#####.......####...............................##...........#........#.......####
####....####.#.#.#.................#.........#.#######.#.#.######.....########.#.#.##........####........#####......###...######
################################################################################################################################
