################################################################################################################################
##...........................................................................................................................###
##...#################################.......###################.......############...###########....###....########..........##
##.....####.##############...#######..........#######......######.......###########...#########........#....#######...........##
##......##....###########.....#####............######........####.......#############.##########.......#.....#######.........###
##......#.....###########......###............######...........###.......#.###.#.##############......#####...######..........###
##.............###########.....................######..........####..............########...#####...#......................#####
##.............############...................######.........#.#####..............######.....####...#......................#####
##..............############.#.###............########......########.............######.......#####.#......................#####
##..............###################....##.#.###########.....#########............#####.........###..........................####
##..............#######################################....##########..........########.........###.........................####
##.............#########################################....###..#####........########..........###..........................###
##.............############.#.#....#####.#.##############...#......###.......#######.................................#.......###
##.............############..........#.......############.........#####.....#####...................................###.......##
##.............##########.................S.....#.##########.......####.....###.....................................##........##
##.#............#######............................########.......####......#......................................####.......##
##.#.............####................................######.......###..............................................###........##
##.#..............#..................................#######.......................................................###........##
##.#...........................###....................#####..................................###...................###........##
##.#..............#.............##....................####.........................###.......###......#####.###....##.........##
##.#..............##.....##.....####.##......#.......####...............##.........###........#.......###...##.....##........###
##.#............####....###.......#######..###.......####..............####.####.#######.............#####..................####
##.#............####....###......##############.....######.......................#######.............#####....#....##.....######
##.#.#........#####....#####.....#############.......######.......................######............#########.###########.######
##.#.#.......######....######....###############....#########.......................####.....................############.######
##.#.#.....########...########..################.....#########.......................##.............##############.######.######
##.#......########.#...#######..##################....#########......................................######.#.##.....###...#####
##.#.....####...........#####..###################....########.........................................#........#....##....#####
##.#.....###.............###....#########....######....#######..................................................#...........####
##.#...###......................########.......####..########...................................................###........#####
##...####........................######........###############.............................#....................####........####
##...###.........................######.........#############.............................###...................#####......#####
##...###...........................####..........#.############...........................###........#...........####.......####
##...##.............................................###########..........................###........###.........#####......#####
##....................................................########...........................###........###.........####......######
#......................................................########.........................###........####.......######......######
##.............................................##........######.........................##.........###....#.#.#####.......######
#..............................................##..........####.........................#.........###.....########........######
##.............................................####.........###...................................###.....#######.........######
#..............................................#####..........#.........................#.........##......######..........######
##...#.........................................##.#.#..................................#...........##......#####..........######
##.#.#..............................................##................................###.........##.......###..........#.######
##.#.#...............................................##.........#.....................###..........##.......##........###.######
##.#................................................###........###................................###................####.######
##.#................................................####......#####...............................####...............####.######
##.................................................####.....########..............#...............####...............####.######
##...................................#.#..........#####...########...............###.............#####...##...........###.######
##..................................######........###.....#######...............#####............###########...........#....####
##.................................#########.....#####...########...............######...........###########.................###
##..................................##########..####.....#########..............#######.........############.................###
#.......####.............#.#........##############.#################............#########......############...................##
##......#####...........######........###########....#####################......###########...###########....................###
#......###########.###########........##########......######################....#######################............##........###
##.....###############.#######.........##########.....#######...........###...#.#######################...........#####......###
#.....####...#########.#.#.#.#.........#########......#####...............#.###..######......#.#....###...........#####.#...####
##.....##....#########...........#.#.###########.....######.................###########..............##...........#.#####.#.#.##
#............#######............#################...#######..................#########................###.............###.#...##
##............######...........#################....#########.#.#.#.#..........########......................#............##...#
##..............####..........##################....###################..........#######..................####...............###
##.#............####.....######################......##################..........########..................###...............###
##.#............####.....###################..........#####...##########.........#########...............###.................###
##.#.#..........####.....###################..........###......########.........###########..............#....................##
##.#.###.......#####.......###############.....................#######..........###########............####....................#
##.#.####.......####.......###############....................................############.............###....................##
##.#.###.........####........###########......................................############............####....................##
##.#.####........####........###########.............###.....................############.............###......##.........######
##.#.###..........###.........#########..............####...................############..............#.......####........######
##...####.........###..........###...####......#...#####.....................############.....................#####.......######
#....####........###...........###...####....###....####......................##########......##........E....######.......######
#.....#####.......##............#.....#########....###...............##.........#########....####............######.......######
###..#######.....###..................#########......................###........#########.....#####.........########.......#####
####.######............................######.........................###........#########.....#####.........#########.....#####
####.########...........................#####.........................####.......##########......###........##########.......###
####.########.#..........................##............................###........###########...####.........####.#####......###
####.###########.........................###............................##........###########.#.###..........##...####........##
####.###########.........................##........................................###############.................###.........#
####.##########.........................#####......................#...............##########.#....................###.........#
####.##########....................#.#.######.....................###...............#######.......................###..........#
####.########......................###...#####.....#########.....####...............######........................#####.#......#
####.##.#####.............##......#####.######.....###########...#####.......#.......#####.......................########......#
####.....###..............###......###########......##################.....#####.....#####........................#######......#
####......................###.....##########..........###########################.....####...........##...........#######.....##
####......................###......#######..............###########...####.#.####....######..........###...........######.#..###
###......................###......######...................#.#.##....#####............#####.........###............######.#.####
###............##........###.......#.#................................###...............##...........................####.######
##.....##....####.......###..........................................######......................##.........................####
##......#...####.........###.....................###.#...............######......................#..........................####
#.......########.........####.....................######...........#.########...............................................####
##........######..........####....................########........######.#####...........................#.................#####
#.........#####...........#####....................########......#######...####.........................###...............######
##..........###............####....................#########.....#######...#####......#.................##.............##.######
#..........................#####...................##########.#########.....###......##................####..........####.######
##..........................####...................####.#.###########......#####....###................###...........####....###
##.........................######.................#####.....#########.......###....####...............#####.........####......##
###........................######...............#.###.........#####........#####...##..............#######..........##........##
##.....................#########..............#######...........####.......#####..###.............########........####........##
####..................##########.............######............####........######...................#####.........####........##
####............###..#########..............#######.............#####.....#####.......................###.......######.......###
####...........############.................######..............#####......####......................###.......#######.......###
####............##########.................####.#...............#.####....####.......................###......#########.......##
###............##########...................#........###...........###.....##.....................#.####......##.######......###
####............########...........................#####............###...###.....................######...........######.....##
####.#..........#######............................####..............##....##.....................######..........#######...####
####.##..........#######.........................######..............###..###.....................#######..........#############
####.###.........######..........................####.................##...###........#.###........######..........#############
####.##...........#.####.........................####................###....###.....#########.....########.........#############
####.###..............#...........................#.........................###....###########.....#######...........###########
####.##...........................................##...............................#############.##########..........###########
####.###................................###........#.#..............................########################..........##########
####.##...............................######......######...............................#####################...........#########
####.###.............................########.....#######..................####.........#############.....#.............########
####.###............................########.....########................######..........#######.#..##..................########
####.###............................#########.....######................########..........####..........................########
####.#....................##........#########....#######...............#########..........####........##...............#########
###......................######.......########....#####.................#########..........###.........##..............#########
##.......................#######........#######..#####.................##########........#####.........###............##########
##......................########..........####.....#.#.................#########........#######........###.#.##.......##########
#..............#####.....#######..........#####...................##.###########.......########......###########.....###########
###....######...######.#######.............####.......##.........###############......###########.#.#########.#......###########
####.#######...#########..####.............######....###.........###############......####################............##.....###
####.#########.##########..................########...####.........#.#.########.......##################......................##
####.##################....................########...#####............########.......##################.......###............##
####.#################..........#.#.#......########.....###..............####..........###############.........####.#.........##
####.################........#########.....#######.....###..............#####.........#################......##########.......##
####...##############.........#########....########....####...........#.###...........#################....############.......##
###...###############.#.....############..########...######.........#######.#.......#####################################....###
#####.##############################################.########################.#.#.########################################..####
################################################################################################################################
