################################################################################################################################
##.....................###########..####..########...#######################.....#############...######...######################
##.###...####.............######...........######.....############...######.......###...........................#######...######
##.........................###..............####......###########.....####.......................................#####........##
##..........................................###........##########................................................#####.........#
##..........................................###...........######.................................................#####.........#
##..........................................###............####...................................................###..........#
##..........................................###.............##.................................................................#
##.........................................####...............................................................................##
##.........................................#####..............................................................................##
##............................##..........######..............................................................................##
##...........................####......########...............................................................................##
##...........................####.....####.......................#####........................................................##
##...........................####.....###.......................#######........................................................#
##...........................####.....##........................#######...................###..................................#
##............................####...###.................................................####.................................##
##.....####....................########...................................................##..................................##
##.....####.....................######........................................................................................##
##......##.......................####.............................................................###...........###...........##
##................................................................................................###...........#######.......##
##.........................................###....................................................##............########......##
##.........................................####.................................................###..............#######......##
##..........................................#######............................................##................######.......##
##.#........................................########..........................................###................#####........##
##.####......................................#######.........................................####................#####........##
##.#####.....................................#######.....##..................................#####................####........##
##..####....................................########....####..................................####............................##
#....###...................................#########....#####..................................##.............................##
#......##..................................####..##......####................................................................###
##......####................................##............###...............................................................####
##.......####.............................................###...............................................................####
##.......####.............................................###...........................................##...................###
##......####..............................................###..........................................####....##.............##
##.....###................................................###..........................................####...####............##
###...###..................................................#######......................................##.....###............##
########.....................................................####...............###..........................................###
#######.......................................................##................###.........................................####
######...........................................................................#..........................................####
######.................................................###..................................................................####
#####..................................................###...................................................................###
###....................................................###....................................................................##
##......................................................#.....................................................................##
##...........................................................##...............................................................##
##..........................................................####...............................##............................###
##......................................................S..#####..............................####..........................####
###........................................................#####..............................####..........................####
###.........................................................####..............#####............##............................###
###..........................................................###.............#######.........................................###
##...........................................................................########........................................###
#.............................................................................#######.......................................####
#................................................................................##.........................................####
#............................................................................................................................###
##............................................................................................................................##
####..........................................................................................................................##
####..........................................................................................................................##
#####...........................#.............................................................................................##
######.........................###..........##................................................................................##
########.......................###..........###................................................................................#
######..####.......##.........###...........###................................................................................#
#####....####.....####........###...........................................................................##.................#
####.....#############........###..........................................................................####................#
####......############........###............##............................................................####...............##
#####.........#########......####...........####...................................................##.......##................##
######...........######......###............####...................................................##.........................##
######............######....................####...................................................#.....................#....##
#######...........######.....................##.........................................................................##....##
#######............#####..............................##.................................................................#....##
########...........#####.............................#####....................................................................##
########............####.............................######....................................................................#
##...###............####..............................#####....................................................................#
##...###.............##......##.........................###.........##.........................................................#
##...###....................####.........................#.........#####......................................................##
##.........................#####..................................#######.....................................................##
##.........................#####..................................#######............##.##....................................##
##........................######..................................######.............#####....................................##
##........................#######.................................####..................##...................................###
##.........................#####...................................##.......................................................####
##...........................................##.............................................................................####
##...........................................##.............................................................................####
##...........................................##.............##..............................................................####
##.........................................................####..............................................................###
##...............................###.......................####..............................................................###
##..............................####........................####.............................................................###
##.#............................####........................####...........................................############......###
##.##............................##..........................##............................................############......###
##.###.........................................................................##.........................#############......###
##.###.........................................................................#####....................################....####
##.##.............................................##...........................######...................########...#####...#####
##.##............................................####...........................#####...................#######.....###....#####
##.#.............................................####.............................###........##...........#####.............####
##...............................................####..............................#........####...........####...............##
##..............................................####..............###.......................####...........####................#
##..............................................###..............####........................##...........####.................#
##.............................................###...............###....................................####.......E...........#
##............#................................###.....................................................####....................#
##..........####...............................##.....................................................####....................##
##.........####.......................................................................................####....................##
##........####.........................................................................................##.....................##
##.......####.................................................................................................................##
##.......####.....................##..........................................................................................##
##.......#####....................#...........................................................................................##
##.......#####...................##...............................###.............##.........................................###
##......#######..................##..............................######...........##........................................####
##.....########.................####.............................#######...................................................#####
##......##..####...............######.............................#####....................................................#####
##...........###...........###########.............................###....................................................######
##...........###..........#############..................................................................................#######
##............#...........#############..................................................................................#######
##.........................#######..##...................................................................................#######
##...........................####........................................................................................#######
##.......................................................................#...............................................#######
##...........................................#.........................####........##....................................#######
##..........................................###.......................#####........##..........................................#
##..........................................###...................#########........#...........................................#
#...........................................####.................#########....................................................##
#...........##..............................#####................########....................................................###
##.........####..............................###.................#######............##.......................................###
###.........####..................................................######...........####......................................###
###..........####..................................................####............####......................................###
###..........####...................................................................##.......................................###
###...........##.............................................................................................................###
###.......##...........................................#####..........................................................###...####
###......####.....................................##############.....................................................###########
##.......####.....................................###############...................................................############
##......#####............##............##..........###############..................................................############
###....#######..############..........#####.......#################..##........####................................#############
###########################################################################..############.......################################
################################################################################################################################
