################################################################################################################################
####.#.##########.#.#.#.#######......#############....#####################################################.....################
##........######.....................############.....####.#############.....##########.....######..######......################
##..........#####......................##########.......##..##########.......##########.....####......###.........##############
#............####.....................######....#...........######.#...........#######........#.....................############
#.............####...................#...#......###........######..................####...............................#.#.#.####
#.............####.................#####.........####.......###......................##......................................###
#..............##.......##.......########.......#####......####...............................................................##
##.....................###.......########........####.......##................................................................##
##.....................##........#########......####.......####..............#.................................................#
###...............................########.......#.........#####...........####...............................................##
###...............................########...............########......#######.................................................#
###................................#####.#...............########......#######..................................#####........###
##.........#................##.....###..................###..####.............................................#######........###
##........####..............#.......##.................###.....#..............................................#####........#####
##.........#####...........##...............###.......###....................................................#####.........#####
##........#######..........#................#####....###.....................................................###...........#####
##.........#####..........###................#####..####....................................................#####...........####
#...........#####.........##.................#####.####................##...................................####.............###
##..........####.........####.................##.....##...............####...................................####.............##
#.........................###........................##..............####...........................###......####.............##
##....................................................#...............##...........................#####......###.............##
#.............S....................................................................................####........##.......##....##
##................................................................................................#####.................#.....##
#................................................................#................................####.........................#
##...............####...........................................####......#.......................####........................##
##...............####..........................................###############...................#####.........................#
##..............###.##..................................##......################.................#.####.......................##
##..............#....##................................#####....#################....................####......................#
##..................###..................................##......################....................####.....................##
###.................###.....#..#.#................................################.....................#.......................#
##.................####....########............###......................#########.............................................##
##.................##.......#######...........######....................###....................................................#
##............................######...........#####..........................................................................##
##.........##...................####...........#........................##....................................................##
###........##....................###....................................#.....................................................##
###...............................##....................................#...........##.......................................###
###................................##.............................................######.................####.................##
##................#.............................................................##########.............######.................##
##.........##...###...........................................##..............#####.#.####............#########................#
#..........####.####..........................................#####.........#####......####..........##########...............##
##..........########..........................................#######.......####.........##..........############..............#
######........######............................................#.#.#......####..........###.......######.#.#.####............##
######.........#####................................................#......###............##.......####.......###............###
#######.........#####......................................................####...........##......#####.........##..........####
#######......#...#.................#.................................#......###...................###..........##...........####
#######......#.#.................####................................##.......#####.............................##..........####
##.#.###......##.................##........###....###................##........#####...........................##...........####
##...###.......................###..........#########...........................###............................###...........###
#......##......................#.............########..........................................................###...........###
##.....##....................###...............#.#####.........................................................####..........###
##......#...................####..................#####........................................................####..........###
##......#....................##....................#####..............................................##.......#####.........###
###.............#..................................#######...........................................###.......######........###
###............###..................###.............###########......................................###.......##########.#.####
##.............###..................#####..........##############..........................###........#........###########....##
##.............###...................#####...........##############.......................######................#.#.#..#......##
#...............###..................#####..........#...###########...................#.########...............................#
#..............####...................####..............###########..................##########................................#
#...............###...................##.................####.######................##########.................................#
#......###.....####....................##.........#.....###....#####..................########.................................#
#....######.....#####...........................####.....###....#####..................######.................................##
##...######....#######.................###......####.............####....................####.................................##
##.########....#######..................##.....######.............##.....................####................................###
###..######.....#####..................####...######......................................####...............................###
###....####.....#####...................###...#######.....................................#####.............................####
##.......#.......##......................#....#######......................................######...........................####
#...............................................#####..................#...................######...........................####
##................................................#.#.#................##....................###.......................#......##
#...................................................###...............................................................###....###
##...................................................####.............................................................###....###
#...................................................####.............................................................####...####
##....................................................................................................................##########
##....................##.................#...........................................................................###########
##....................####.............#####.........................................................................###########
###...................#######..........#######................................................##.....................###########
###.....................######.........#########.............................................###.........#..........############
####....................#######........#########.............................................###........####.........###.#.#####
###...........#.#........######.........########.........................................E....#.........#####.......####....####
###.........#####........#######.......########...................##....................................#####.......###......###
###........#####.........########......########..................#####...................................######...####........##
##........####...........#####.##......#######....................####.#.................................######.#.#####........#
##.........#...............#....###...#####.#....................########.#..............................#############........##
##...............................##...#####.....................#########.##...###.......................###########...........#
##..............................###.....#.......................#########.#######........................########.............##
##..............................##...........##.................#......##.######.........................#######..............##
###...................#.......###...........####.......#..................######.........................######...............##
####................####.....###............####......##...................###............................#####..............###
#####...####........###......##.............##........#....................###..................###.......#####...............##
###############......#......##..............###............................#....................####......######..............##
###############.............#...............##......................###...##.....................###.......######.............##
##############......................###.....###.....................#####.#......................###.......#######.............#
#############.....................####.......###......##.#.##........####.#.......................##.........#######..........##
#######...#.....................######.......####......######.........###.........................##.........#######...........#
#######........................######.........###......######...........#..........................#...........######.........##
#######.......................#######........####........###...................................................######..........#
#########......................#####.........###.........###...................................................######.........##
##########........#............###.........####..........##....................................................#####..........##
##########........#.......................###............#...........................#.#.......................#####..........##
###....####......##......................##.........................................####.......................####............#
##.....####..............#...........................................................####.....................####............##
#.......###.............###............##.............................................................##......#####............#
#.......###.............###............#.............................................................#####....####............##
#........###..............#............##............................................................######.######.............#
#.......#####........................................................................................############..............#
##.......#####..............................................................................##.......###########...............#
##......#######...................................................###.#....................###......###########................#
#.......########......................................#.........#######....................##.......##########.................#
#.......#######......................................###......########.............................##########..................#
#.......#####...................#.....................#.......#######..............................########..................###
#.........####.........###....####...................##......#######...............................####..........####........###
#.........###..........###########...................#......######.................................####.........#####......#####
#...........#..........###########..................###.....####...................................##..........#######....######
#.....................#############.................###.#.####..............###...................###..........#######......####
#......................#################............########..............######..............................########........##
#......................#################.............#####...............#######................#.#...........#####.#.........##
#...............................#######..............##.................###.#.###...............##............###..............#
#.......##.........................#####..............................#####...###...............##............###............###
##......##.........................####.............................#####......###.....#......................##.............###
##..................................####..........................#######......##.....###.....................###..........#####
##..................................###..............#..........#######...............####.....................###........######
##..................................##...............#.........##.#.#.................#####....................###......########
##.....................#............................##........###.....................######....................####...#########
##....................##............................#.........##.....................#######.......###..........####...#########
###..................###.......###.................###.......####...................##########...######..........#####..########
######..............#####....#####...........#.....###.....#.#####..........###.....##########.#.########......#######.#########
#########.#........#################....#.###########################.#.#.#######.##############################################
################################################################################################################################
