################################################################################################################################
###.......................................................................................................................######
###.###......####......########.......###################.....#############################........#.####..........######.######
###.##.......###........####...........#####...######..........##################.....####.........#.####...........#####.....##
###..........###........###.............##.......####...........######.###...###.......###........##.###............####.......#
###..........####.......##........................###...........#####........###.......###........##.##............#####.......#
###..........####.......##......................................####...............######.........##.##............####........#
##............####..................##..........................####..............####............##.##............####.......##
##............####.................###..........................####.............####.............##.###..##........##........##
##............####..............######...........................####..###......####...............#.########.................##
##.............##..............#######............................#########....####................#.##########...............##
##.............................######........................##......######...####...................##.....####.............###
##..................##.........######.......................#####.....####.....##............................###.......##...####
###................####.........######.............####....#######.....###..........##.......................###......###.######
###................####............####...........#######.########......#..........####.......................#.......###.######
###.................####............###..........########.########.................####...............##..............###.######
##...................##..............##.........#########.###..####.................##...............#####............###.######
##..............................................####..###.......##...................................########..........##...####
##...............................................##........................####..............###......########...............###
#...................................................................##....######............####......########................##
#..................................................................####..#######............####.......##..###................##
#......................................###..................##....#####...######............#####...........###...............##
##.....................................###.................####...####.....#####............######..........###...............##
##.....................................###.................####.............#####..........#######...........#...............###
##...............###...................####................#####.............####.......##########..........................####
###..#######....#####.................######................####.............#####.....###########...................##.....####
###.#########....###.................#######................####..............####....############................######.....###
###.##########.......................#######................###................####...########...................#######......##
###.##########......................#######.................##..................##.....#####.....................#######.......#
###.###########...............###..######.............#................................###.......................######........#
###.##.....####.....#........##########..............###..............###..............##....##...................##...........#
###.........###....####.....#########...............####.............#####.............#....####..............................##
###.........###....#####....#####..................#####.............######..........##....#####..............................##
###........####.....####.....###...................####...............#####.........##.....#####.............####.............##
###........#####.......##..............................................####........###.....####.............######............##
##..........#####.......##...............#####..........................##.........###....#####............##########.........##
##..........#####.......#####...........#######.....................................#.....#####...........#############...##.###
#...........####.......#######..........######................................................###........################.######
#...........####.......#######...........#####......####.......#................................##......######.....######.######
##...........##........######.............#####...######......#######..........................####......#..........#####..#####
###.....................#####...##.........############........########..............#.........####.................####....####
###......................###...####.........###########.........########............###.......#####.................####....####
###............................####...###..###########...........#######...........###........####..................####....####
###............................####..#################............#####............###........##...................######...####
###............................###...#################............####..............#.............................########..####
###..................................#####......#####..##........#####........................................############..####
###.....................#.............###........###...##........#####......................................#######....#########
###.#####..............###..........S............###........##..#######.....................#......#.......#######......########
###.######..............#........................###.......############....................####...##......########......########
###.######.......................................####.....############.....................#########.......#######......########
###.#######......................###...###.......####.....############.....................#########...........####.....########
###.#######..................##############.....#####.....######..####......................#######.............####....###..###
###.#######.......##.........#########################....#####....###.......................#####.............#####.....#....##
##..#######......#######.....##########################...###......####..#########............................######..........##
###..######.....##########....####################...####.##........##...##########..........................######..........###
###..######....############..###############..###....####.##..............########.................#........#####............###
###...#####...#############################.........#####.##..............######..................##........#####...........####
##.....###...######..##################.............#####.#...............#####................#####.........####...........####
##...........#####....#################.............##..#..................###................######...........####.........####
###...........##..........###...#######.....................................##.....######.....######............####.........###
###..............................######.....................................###...########....######.............###..........##
###.#............................#####..........##..........................##############....#####...............##....###...##
###.#.............................###..........####........................##############......##.......................####..##
###.#.........................................#####....##.#...##..........###############................###............####..##
###.#.......#####.............................####....###.######.........################...............########.........##...##
###.#......########............................##.....###...####......####################............###########.............##
###.#.....##########...................................##............#########...###############.....#############............##
###.##....##..######................................................########......#.............#....#############............##
###.###..###........................................................#####.........####......#####.....#############...........##
###.########.........................................................##...........###.........##.......############...........##
##...##########............#......................................................####..................##########.............#
#....###########.........####................................................##....####.................########...............#
#....###########........####.....####.............................####......####...#####...........#...########................#
#....############...#######......#####...........................########...#####...######........##.#########.................#
#....############...#######......######........................###########...####...#######.......##.#########.................#
##....######...##...#######.......#####.......................############...####...#######.......##.########..................#
###....#####........##########....#####........................############..####...#######......###....####...###....###.....##
###.....####........###..######...####.............................########...##....######......####.....###....#....####.....##
###.....####.......###....#####..#####......................##......######..........######.....###.......###........######....##
###.....####......###......###..######.....................####.....######..........######....###.........#........#######....##
###....######.....##............#####.....................#####......####...........#####....###..................########...###
###....#####.....###............####....................#.######.....#####.........#####...#####..................#########.####
###.....#############............##....................##.########....#####.......#####...######..................##############
###..........#########................................###.#########....####......#####....######.......#####.......#############
###.#.........########.............................######.########.......#......######....#####........######.......############
###.#.........#######...........................#########.##....................######.....##..........##..#######...###########
###.#.........#####.......................##..###########........................######.....................######....##########
###............##........................################...........................####.....................#####.....###...###
###....................................########..#######...##........................####.....................................##
###.#.................................########.....####...####...##...##.............#####....................................##
###.###................................#######.............####.##########...........#####..................####..............##
###.####.................###..............####..............###############...........####..........E......######.............##
###.####................#####..............####..............#########...#............####.................#########..........##
###.####...............#######.............####................#####...................###.....##..........##########.........##
###.###................##########..........###...................##....................###....####.........#########..........##
###.###................###########..........#........####.............................####....#####.........######............##
###.##................###......##...................#####...............###...........####....######.........#####............##
###.##...............###............................#####..............#####..........####.....#####.....##...#####...........##
###.#...............#####...........................#####.............#######..........###......####....####...#####..........##
###.............###########............##...........####............########............#........###....#####..#####..........##
###............#############..........####..........####........###########.......................##.....#####..####.....#....##
###...........##############.........####..........######......############.......##......................####.#####....###..###
###...#############..#######........#####........########......############......###...........................#####....###..###
###..#############....######........#####.......####...#.......############......###..........................#######..####...##
##...############....#######.........####......####.............##########......###...........................#############...##
#.....#########......#######..........##.......####..............#######.......####............................###########....##
#..........###........#####.....................###..............######......######.............................####..........##
#..............##.....#####......###............###...............####......########.............................##..........###
##............####....######.....###...........####........................#########.............................##..........###
##............####...#########.................####.......#................#########...............#.#...........###.........###
###...........####...##########................###........#.................#######...............##.#...........###.........###
###.######...####.....##..######..........................#.................###................#####.#...........##..........###
###.############............#####...........................................##................######.#........................##
###.############.............#####.........................................##..........##....#######.##.....##........##......##
###...###########............#####........###..............................##.........####..########.##########....######.....##
##.....#############........######......######......###....................###........###...########.###########..#######....###
##.....#############.....########......#######.....######...................###.............########.####################...####
#.....#############.....########......#########....######....##..............##.............########.###################....####
#....####.....####.......#######.....##########....######.######.............................#######..#######.#####..##.....####
#....###.......###........#####.....############....#####.######.............................######.....####...###..........####
##...###........###.......#####....#############....#####.#######.............................#####......###.................###
##...###........####......####....###############...#####.#########............................#####.....###..................##
##.............#####..............################..#####..#########.....#.....................#####......##..................##
##.............#####....#.........################..#####.......###########....................#####......######..............##
###...........#######..###........#######################........##########...................######......#######.............##
####.........#############.......#########################......############...#####.........########....#########...........###
###########################.....############################..##################################################################
################################################################################################################################
