################################################################################################################################
###########......................................................#########################.....##################..#############
###########...........##############..........#############.........##########........###.......#####..#########......##########
###....................#####...#####..........############...........########...................####....#######........#########
##.....................####....#####..........###########.............#######...................####......####.........#########
#.....................#####...######..........#######.................######...................#####.......##..........#########
#....................#####.....#####...........#####.....####.........#####...........###......######............##...##########
#.................#######.........#.............####....######.......#####...........#####......#####...........################
##...............####............................###...#######.......####............#######.....###............################
####.............###...................#................######......#####............########..................#################
#####...........####..................###.................###......#######...........#########.................#################
#####.....####.######........#........###..................##....############.........#########...............######..#####..###
#####....#####.#######......###.......###..................###..####..########...........##########.......#########...........##
######..######....####......####......###..................###.####....######.............#########......#########............##
###########........####......###.......#...................###.####....######.............#########.......###.................##
##########..........####.....###............................##.####....######............##########............................#
##########..........####....####.............................#.###......####...........############................##..........#
###########..........##......##................................##.....................#############................####........#
###########....................................................##....................#############.......###.......#####......##
############...................................................##...................#############........###........######...###
###########....................................................##...................#############.........###........###########
#######........................................................##....................###########...........#####.....###########
######.........................................................#.....................##########.............#####....###########
######....##..................................###....................##...............###...##...............####.....##########
######...####....########....................#####..................####...............#......................###.......########
#####....####...##########..................######.................#####.......................................###..##..########
####.....####...##########..................######...............#######................................#.......################
####.....####....#########...................####...............#######...........##...................###.......###############
####.....####....##########.............................##......######...........####.....########......#...........############
#######...##......#############........................#####.....####............#####...##########..................###########
########...........#############.......................######.....###............#####...##########..................###########
#######...................########....................#######......###............###....#########.......................#######
###................................##...............##########.....######...............####..##..........................######
##............................########.............###########.....########.............###...............................######
###...............................####............########..........###..##..............#...........#####................######
######.........###.................##.....###############....................................##.....########.............#######
#######.....##.####...##..................############......................................#####..###########.....#############
#######.....##.#########....................#########......................................####################...##############
########.......#########.....................########......................................############.########################
#########.......########...##.................######.......................###........##..############...############...########
#########........######....##..............................................####..#####################...###########.....#######
#########.........####....###.....................................##........##########################....##..#####.......######
#########.................##.....................................####........#########################.........###...........###
#########....#.#......................S..........................####.........#######..#######......###.......................##
##..####....##.#####............................................######........#######..######........##.......................##
#...........##.######.............##............................#######.......######...######........###......................##
#...........##.######............####...........................#########......##.....######........####........##............##
##...........#.#####............######...........................########............####..........#####.......####...........##
##.............................##########........................########...........####...........######....######...........##
###............................###########..................##....##................####............###############..........###
###......................#.....###########..................##.......................###..............#############..........###
###.....................###.....#########..............................................................####....###...........###
####......##......#.....###......####........................................................................................###
####.....####....###....###......###......................................#######.............................................##
####...######....####....#................................................########..................##........................##
###...#######.....###........................###..........................########.................####...............##.....###
##....#######.............................#######..........................########................#####.............###########
#.....#######............................########...#######.................#######................#####.............###########
#.....#######...........##...............#######....########...####..............##.................####.............###########
##....#######..........####...............###........#########.#######..............................###..............###########
###...######...........####...###.....................########.########.............................###..............###########
####..#####.............###...###..............................#########...........................###..............############
####...####.....#........##...###........##....................############..............##........###..........#..####...######
###....####....##........##....#........#######.................###########..............###...................#######....######
##.....####............................#########................###....####..............####...................######...#######
#......####.............................#######.................##..............##........###............###.....####....#######
#......####.....................................................##.............###.........#............#####....####....#######
#......####...................................................................###......................######.....##......######
#.......##...................................................................###.......................######..............#####
##.......................###.................................................###......................#######.............######
###.........##..........#####.......................##................................................###..............#########
###........###...........####..................##...########.................................###...#####..............##########
####........##...........####.................####.##########.....###.......................####....###................#########
####.....................###...................##.############....####.......................##..............................###
#####...................###......##................#####..####....####...............#........................................##
########.......###.....###......####................###....###.....####..............##.......................................##
#########......###.....##........###................###....###.#....###........##....#.........................##............###
#########.......#.................##................###....###.##...###.......###.................###.........####...........###
#########......................................##....#......##.##....#.....######.................###........#####...........###
#########.............................###.....####........................#######.........###..........###...####............###
##..####.............................#####.....###........................######.........#####.##.....####....###............###
##...##.........................#...######......###........................##............#########....####...................###
##.............................###...#####......###.................#....................#########....####...................###
#..............................###......###.....###................###....................#########..#####........##.........###
#........................................##.....###...............####..........####.......#############.........####.........##
#.........##.............................###....##...............######.........#####.........#########.........####..........##
##.......####.............................##....##..............#######.........####...........########.........####.........###
##.......####..............................##..###....###......#########.........###............#######..........##.......######
##.......####............##........###.....######.....###......##########........................######..................#######
###.......###............###.......####....######......#.......##########................##......#######.................#######
###........###............####......##......####.................#######................######..###########...............######
###........###.............####...................................#####.................####################...............#####
###........###..............#####.................................####............##.....###################..................##
###.........##...............####..................................###...##......####.....#################.......###..........#
####.........#................###.....................................######.....#####....##############..........#####........#
#####....................................................##...........######.....######...#############...........#########....#
#####...................................................####...........#####......#####...#############............#########...#
###..####.........##...........................##.......#####...........###.......######...#############...........#########..##
##...####........####..##....................####.......######....................######....############...........#########..##
##....###........###############............#####.......######....................#######...############............#######...##
##................###############............###........######.#..####............##..#################...............####.....#
#...................###############.....................######.########................##############..........................#
#............................######.............##......######.########.................##########.............................#
#............................................######......#####.########.................##########.............................#
#...........................................#########....#####.#########...............###########.............................#
#...............................###........###########...#####.##########..............###########.............................#
#..............................#####.......###########....####.###..#########...........#########.......#......................#
#.........................##....#####.....########........####.##....#########............#######......##......................#
#........................####....################.....#...####.##......#######.............#####........#......................#
#................##......####.....##############.....#########.##.......#####...............####.........................#.....#
#..............####.......####....########.........###########.###.......###................####........................###....#
#..............####.......####....#######.........############.###........E................######.......................####..##
##...###.......####........##......######.........############.###.......................#########......................########
########.......####.................#####.........############.####.....................###########.............###.....########
########.......#####.................###..............########.#####............###....#####.#######..###.......###......#######
#######........########................................#######.#######..........####...####...###########.......###.......######
######.......#.#########.....#.........................#######....#####.........#####...##....##########.........#........######
#####.......##.#########....###..........##.............######....#####..........#####.......########....................#######
######.....###.#########.....#..........###..............###......####............###.......######......................########
#########.####.#########............#######.....................#####.......................#####..........##..........#########
#############...########...........########....................#####.........##.............####..........###..........#########
#############....#######............##..####................##.#####........####.............##............##...........####...#
#############.......####.......##........####..............###...###.......########...........................................##
#############........####.....####.......####..............##.....###......############..............###...........###........##
#############........#####....#####.....######..###........##......#####...#############...........######........######......###
##############.......######..########################.....####.....#####################..........########.....##########...####
###############.....############################################..#######################.######################################
################################################################################################################################
