################################################################################################################################
################################################################################################################################
################################################################################################################################
################################################################################################################################
################################################################################################################################
####......######################################################################################################################
################################################################################################################################
################################################################################################################################
################################################################################################################################
################################################################################################################################
################################################################################################################################
################################################################################################################################
################################################################################################################################
################################################################################################################################
################################################################################################################################
################################################################################################################################
################################################################################################################################
################################################################################################################################
################################################################################################################################
################################################################################################################################
################################################################################################################################
################################################################################################################################
################################################################################################################################
################################################################################################################################
################################################################################################################################
################################################################################################################################
################################################################################################################################
################################################################################################################################
################################################################################################################################
################################################################################################################################
################################################################################################################################
################################################################################################################################
################################################################################################################################
################################################################################################################################
################################################################################################################################
################################################################################################################################
################################################################################################################################
################################################################################################################################
################################################################################################################################
################################################################.###############################################################
################################################################.###############################################################
################################################################.###############################################################
################################################################.#############################..........................########
################################################################.#############################..............####################
##########################################################.............#######################..............####################
########################################################.................#####################..............####################
######################################################.....................###################..............####################
####################################################.........................#################..............####################
######################################........................................################..............####################
######################################.........................................###############..............####################
######################################..........................................##############..............####################
######################################...........................................#############..............####################
######################################............................................############..............####################
######################################............................................############..............####################
######################################.............................................###########..............####################
######################################.............................................###########..............####################
######################################..............................................############################################
######################################..............................................############################################
######################################.........................................E.....###########################################
######################################...............................................###########################################
######################################...............................................###########################################
############################################.........................................###########################################
############################################.........................................###########################################
############################################.........................................###########################################
#######################################...................................................######################################
############################################.........................................###########################################
############################################.........................................###########################################
############################################.........................................###########################################
############################################.........................................###########################################
############################################.........................................###########################################
############################################.........................................###########################################
#############################################.......................................############################################
#############################################.......................................############################################
##############################################.....................................#############################################
##############################################.....................................#############################################
###############################################...................................##############################################
###############################################...................................##############################################
################################################.................................###############################################
#################################################...............................################################################
##################################################.............................#################################################
###################################################...........................##################################################
####################################################.........................###################################################
######################################################.......S.............#####################################################
########################################################.................#######################################################
##########################################################.............#########################################################
################################################################.###############################################################
################################################################.###############################################################
################################################################.###############################################################
################################################################.###############################################################
################################################################.###############################################################
################################################################################################################################
################################################################################################################################
################################################################################################################################
################################################################################################################################
################################################################################################################################
################################################################################################################################
################################################################################################################################
################################################################################################################################
################################################################################################################################
################################################################################################################################
################################################################################################################################
################################################################################################################################
################################################################################################################################
################################################################################################################################
################################################################################################################################
################################################################################################################################
################################################################################################################################
################################################################################################################################
################################################################################################################################
################################################################################################################################
################################################################################################################################
################################################################################################################################
################################################################################################################################
################################################################################################################################
################################################################################################################################
################################################################################################################################
################################################################################################################################
################################################################################################################################
################################################################################################################################
################################################################################################################################
################################################################################################################################
################################################################################################################################
################################################################################################################################
################################################################################################################################
################################################################################################################################
################################################################################################################################
################################################################################################################################
################################################################################################################################
