################################################################################################################################
########.#.#.##...........#.........#.#.#..........#.#.##.#.#.#.#.....###############.#.#......###.#.......###.#.#.#.###########
##......................................................................######............................................######
##.......................................................................####...............................................####
#.............................................................................................................................##
##............................................................................................................................##
#..............................................................................................................................#
#..............................................................................................................................#
#..............................................................................................................................#
#..............................................................................................................................#
#..............................................................................................................................#
#..............................................................................................................................#
#..............................................................................................................................#
##.............................................................................................................................#
##.......................................................##....................................................................#
###.....................................................##.....................................................................#
###............................................................................................................................#
###............................................................................................................................#
##.............................................................................................................................#
#..............................................................................................................................#
#.............................................................................................................................##
#..............#...............................................................................................................#
#.............##..............................................................................................................##
#.............................................................................................................................##
#.............................................................................................................................##
#..............................................................................................................................#
#..............................................................................................................................#
#..............................................................................................................................#
#..............................................................................................................................#
##.............................................................................................................................#
##.............................................................................................................................#
#..............................................................................................................................#
#..............................................................................................................................#
#.............................................................................................................................##
#..............................................................................................................................#
#.............................................................................................................................##
#..............................................................................................................................#
#...S.........................................................................................................................##
#..............................................................................................................................#
##..............................###...........................................................................................##
##............................#####.......................................................................##...................#
##...........................#####.......................................................................###..................##
#.........................................................................................................#....................#
#..............................................................................................................................#
#..............................................................................................................................#
#..............................................................................................................................#
#..............................................................................................................................#
#.................................................................................................#............................#
#...................................................................##...........................###...........................#
#...................................................................##............................###..........................#
#..................................................................###.........................................................#
#...................................................................#..........................................................#
#..........##.....................................................###..........................................................#
#..........####...................................................##..........................................................##
##...........##...................................................#............................................................#
##............#...............................................................................................................##
#..............................................................................................................................#
#.............................................................................................................................##
#..............................................................................................................................#
#.............................................................................................................................##
#..............................................................................................................................#
#..............................................................................................................................#
#..............................................................................................................................#
#..............................................................................................................................#
#.............................................................................................................................##
#..............................................................................................................................#
#.............................................................................................................................##
#.............................................................................................................................##
#.............................................................................................................................##
#.............................................................................................................................##
#..........................###................................................................................................##
#..........................####...............................................................................................##
#.........................#####...............................................................................................##
#..........................###................................................................................................##
#...........................#................................................................................................###
#.............................................................................................................................##
##............................................................................................................................##
##.............................................................................................................................#
###............................................................................................................................#
##.............................................................................................................................#
##.............................................................................................................................#
#..............................................................................................................................#
##.....#.......................................................................................................................#
##.#.#####....................................................................................................................##
###########...................................................................................................................##
####.#.####.................................................................................................................####
###.....###...............................................................................................................#.####
##.......................................................................................................................#######
#........................................................................................................................#######
#....................................................................##.....................##...............................###
#...................................................................##.....................####...............................##
#..........................................................................................###.................................#
##........................................................................................####.................................#
##.......................................................................................E###..................................#
###......................................................................................#####.................................#
##..............................#........................................................####..................................#
##.............................###.......................................................#####.................................#
##.............................###........................................................###..................................#
##............................####.........................................................#...................................#
##............................###..............................................................................................#
##............................#................................................................................................#
##.............................................................................................................................#
##.............................................................................................................................#
##............................................................................................................................##
##.............................................................................................................................#
##............................................................................................................................##
##..................................................................................................##.........................#
###................................................................................................###........................##
###................................................................................................###.........................#
####................................................................................................#.........................##
####.................................................#.##......................................................................#
###................................................#######....................................................................##
###...............................................########.....................................................................#
##................................................######......................................................................##
#................................................######........................................................................#
#................................................####..........................................................................#
#................................................##............................................................................#
#..................................................................................................................#...........#
#.................................................................................................................###.........##
##................................................................................................................###..........#
##............................................................................................................................##
##.............................................................................................................................#
###...........................................................................................................................##
##.............................................................................................................................#
###.............................#.....###.....................................................................................##
##............####..........#######.#.####............................#.#.#...................................................##
####.#.#.#.#######.#.#.#.###################.#.#...................##########........##...........#.#.#.##.#.#.#.###.#.#....####
################################################################################################################################
