################################################################################################################################
########.#.#.#.#######.#.#.##########################.#.#.#.################.############........#.#.#.#########################
#####........................#####...#############...............####..........########.........................#.##############
###..........................#####.....###########................###............#.#................................############
##...........................####......#########......................................................................###.######
#..........................#######......########............................................................................####
#..........................###.###......######.............................................................................#####
#........................####....###....#####.............########........................................................######
#......................#####....####....###..............##########.......................................................##.###
#....................######......####...###..............###########.....................................................###...#
#...................#####.......#####...................################...........#####.................................##....#
#..................####..........####...................####...###########........#######................................##....#
##..................##..........####...................####....#########..........#######................................##....#
#...............................#####...................###......####.............########.....................................#
#..............................#######..................###......####..............######.........#............................#
##.................###.........########...........................##..............########........####.#.......................#
#..................####.........#######...........................####............########.........#######....................##
##...............#######.............###...........................####.........#####.####.........#...####...................##
#................########............###..................##........####.......####......#...#.#........##....................##
##...............##########................................##.......#####......####........#####.........###..................##
##...............#####.####................................##........##........###..........####........####...................#
###....#..........##.....####.................#............###......###.........###........####..........######...............##
#########.................###.................#............##.......##...........#..........###.........###.####...............#
########....................###..............##............###......#............##........##.................##..............##
########....................###..............##............##......###............##.......##................###...............#
#######.......................##............##............####.....##.............##......###.................................##
######........................####..........###...........###.....................##......####....##..........................##
####............................##.........###...........#####.....................#.....############.......................####
####............................####.###.#.####..........####............................############.............#.....########
##...............................##############...........###...........................#############............###############
##...............................###############........................................#########.#..............###############
##................................#############.........................................#######..................######...######
##.....S..........................#############...........................................#.....................#######...######
##................................############........................#..........................................####......#####
##.................................######.#.#.......................###..........................................####......#####
#..................................###.............................####...........##..............................####.....#####
##....................................................###..........###...........###...............##............#####......####
#....................................................###.........................####......###...#######..........#####.....####
##..................................................#####.........................#.......################........#####.......##
#....................................................####.................#..............#################.........#####......##
##......................................#............######..............###.............#################.........#####......##
#.......................................##.............######.#..........##.............##################...........###......##
##.....................................................##########.......###.............##################...........###.....###
##......................................................##########......###............####....#.#.#######...........###......##
##................................###...................##########.....####...........####..........######...........###.....###
##...............#.............#######................###########......###...........####............#####............###.....##
##.............###............#######...............###########.........##..........###.#............####..............#......##
#.............................####..................###########.....................#................####.....................##
##...........................###.....................#########.......................................####.....................##
#.............................###...................###########......................................####.....................##
##............................###.......####.........#########........................................###.....................##
#...............................###.#.#######.......#####.#####.......................................###.....................##
##................................######.#.#.........##....####.......................................###.....................##
#.................................####..............###.....###......................................#####....................##
#...........#.###............................................##..........##.........................######....................##
#.........#######............................................###.........######.................#.#########...................##
#.......########.............................................###..........#####...............#############...................##
#.......######.......................#...............#........###...........#.................######...####...................##
##....#######....................#.####.............##.......####..............................####......#....................##
##.#.########..................#######...............#........###..............................###.......##..................###
#############..................#####.........................####....................#..........#...................##.#.#.#####
###############...............####...........................####..................####..................###.........###########
###############................##.............................###.................######.............................###########
#######.#......#..............................................###.................######..............................##########
######.........................................................##................#######..............................##########
###.............................................................................########..............................##########
###...................................#.........................................#######.......................#......###########
#.....................##..............####.#...................................#######.......................####.#.############
##..................####................######..................................##............................#########.#.######
#...................#####.................####.................................................................######.......####
#..................######..................####......................###.........................................#..........####
##..................######..................###......................###.....................................................###
#...................######..................###.....................###......................................................###
##..................######..................##......................###.......................................................##
##...................#####.................###.......##............###......###..................................#.#.........###
##...................#.#..................###.........#............###.....####................................######.........##
###.......................................###.........##..........###......#######...........................#########.......###
###.......................................#.......................###.....##########.......................##########.........##
###................................................................#.......#######........................##########.........###
##........................#.................................................######..................#....##########..........###
###.......................###................................................####.................####.....########...........##
##........................####...................##............................#.................#####......#######..........###
##............###..........##...................###..............................................#####........#.####..........##
##..........#####.........####..................##...............................................#####...........###.........###
##..........######........###..................###..............................................#######...........##..........##
##........########.........#.......##.........###................................................######......................###
##........########................####.......####..............###..............................######.......................###
##.........#######................###.......####...............###..............................#######......................###
##............###.................###......#######............####............................########.......................###
##...............................###......########.#..........###.........########............######.........................###
##................................##......############........###.........#########...........####...........................###
##........................................#...#######..........#..........#########..........###............................####
###...................#####....................######.........##..........########..........................................####
####..................######....................####..........##............#..............#.#..............................####
####......................###.......#.......................#####..........................##................................###
####.................................###....................####..........................###...............................####
####.................................####..................####...........................##.................................###
###...................................###..................####.............................................................####
###....................................##....#..............#...........#...................................................####
##...................#####............####..####......................###..................................................#####
####.................#######...........##....###......................##...................................................#####
####................#########.........###....####....................##.....................................E.............######
#####...............#########................####..........................................................................#####
#####................#########..............#####................#...................########.................##..........######
#####..................#######..............#####................##.................##########.................##.........######
####.......#...........#######.............######................#..................#########..........................#########
###.......####...........#####..............####....................................########...........................#########
###........####..........#####...............#........................................####.............................#########
###.........####...........###...........................................................................................#######
####.........#########....................................................................................................######
#####.........########.........................................###............................................##...........#####
######........########...................................#.....#####...........................................##.###.......####
#######........######...................................##......#####...........................................#####........###
##########.#.###.#.#............................................#####...........................###.............######........##
###......#######......................##.........................####..........................####..............#####........##
#......########.......................####......................####.........................######..............#####........##
##......########.........##............###.......................###...........................#####..............####........##
#.......#########.......####...........####...##........#.#.....###..............................##........##.......##........##
##.......#########....####.....#.........#.....##.....#######...#####.....................................###.......##........##
#........#.#######...#####.....#..............###.....#######...#####.....................................#####...............##
##.........#############.......##..............##......######....#####...................................####.................##
#...........######.#####................##....####......####......#####..............#.#.#.#.............#####................##
##............#......#.................####....###........#......######............#########.............######...............##
#.....................................#####...######............#######...........###########............########............###
##...........................###.....########.######..........##########.........###########.......#....##########...........###
##......#..................#####...###################.......###########.........#############....#################.........####
###...#####.#.###.........############################......##############.#.#.################.################################
################################################################################################################################
