################################################################################################################################
##########################.#.#.##########....##.#.#.#.#.#.#.#####################.#.#.#.#.#.#.#.....####.......######.##########
############.#.#.....###.......########.......................########.#.#.####..................................##.....########
##.#.##.#........................#####..........................####....................................................########
##...............................###..............................#.....................................................########
#....................................................#............#.....................................................########
##...................................................###..........#......................................................#######
#....................................................###.........###.....................................................#######
##.............#......................................###........##........................................................#####
#............####.....................................###..................................................................#####
##............###......................................###...................................................................###
##............###......................................###..................................................................####
##...#..........##.....................................###.....................##...........................................####
#######................................................####...................#####.........................................####
##..####................................................####...................#####.......................................#####
###...#..................................................###....................####.......................................#####
##..........................................................................................................................####
##..........................................................................................................................####
##..........................................................................................................................####
##...........................................................................................................................###
##............................................................................................................................##
###..........................................................................................................##................#
##.....................#...............................###..................................................####...............#
###..................###..............................#####..................................................###...............#
####................############......................#####....................................................#...............#
#####..............####.#.#######......................###....................................................................##
######.....................######......................####...................................................................##
#######.....................######............................................................................................##
#######......................#####.............................................................................................#
##.#####......................####.............................................................................................#
##...##........................####....................................................#..............................#........#
#................................#....................................................###............................####......#
##.....................................................................................##............................####......#
#.......................................................................................#.............................####.....#
##..........................................................................###.........................................##.....#
#...........................................................................####..............................................##
#.............................................................................###.............................................##
##............................................................................###.............................................##
#.............................................................................###............................................###
##.............................................................................##............................................###
#..............................................................................#.............................................###
##..........................................................................................#.................................##
#...........................................................#..............................##.................................##
#..........................................................###................................................................##
#..................##......................................###.................................................................#
#..................####....................................###.................................................................#
#..................#####...................................###.................................................................#
#..................#####...................................###.................................................................#
#.................#######...........................S......###.................................................................#
##..............########............................###....###.................................................................#
###............#########..........................#####.....#..................................##..............................#
###............#######.............................##.........................................####.............................#
###............#######........................................................................###..............................#
##..............#####.........................................................................##...............................#
##.............######....................................##...................................................................##
#..............######...................................####...................................................................#
#............#######.......##...........................####..................................................................##
#............######......####.........................###.##..................................................................##
#..............##.......####..........................###...................................................................####
#........................###........................####...............###...................................................###
##.................................................####.................##...................###............................####
###...............................................#####......................................####.............................##
####..............................................###.......................................####..............................##
#####........................................................................................###..............................##
######.......................................................................................##................................#
######........................................................................................................................##
#######.................................................................................................................#......#
######.......................................................................................................##........##.....##
######...............................................................#.##...................................###........#......##
#####................................................................#####.................................####.......##......##
##..................................................................###....................................###........##......##
#.........................................................................................................#####................#
#..........................................##.............................................................####................##
#.........................................###...........................................................########...............#
#..........................................####........................................................#########..............##
#..................................#.......####..................................##...................##########...............#
#................................#####.......##.................................###....................#.#.##.................##
##...............................#####..........................................###..................###.....................###
#.....................#.........#######.........................................#....................###.....................###
##...................##.........#######...............................#................##...........########................####
#....................###..........#####.............................###................#.............#######.................###
##....................#............................##...............##...............................#######.................###
#.....................#.#........................#####...............................................######..................###
##......................#........................####...............................................###....................#####
##......................##........................#.................................................###....................#####
###.....................#...........................................................................##......................####
###..................................................................................................#.......................###
#####.........................................................................................................................##
#######........................................................................................................................#
#########......................................................................................................................#
########.......................................................................................................................#
##..#####.......................###............................................................................................#
#....###........................###.....................................................................#......................#
#....####......................#####....................................................................##.....................#
#.....##.......................####.....................................................................#.....................##
#.....##........................####..........................#................................................................#
#...............................####..........................##..............................................................##
#.................................####........................##..............................................................##
#.................................#####........................#..............................................................##
#...................................##................##......................................................................##
#.....................................................###.....................................................................##
#......................................................#......................................................................##
##............................................................................................................................##
###.................................................................................................#.........................##
####...............................................................................................###........................##
#####............................###....................#...................#####..................####.......................##
#####............................###...................####...............#########.................##........................##
#####............................###...................####...............###..####..........................................###
####.....................#......####...................####...............##....####.............................#..........####
####....................###.....###.....................###......................##...........................###............###
##......................###.................................................................................#####...........####
##.......................#..................................................................................###..............###
#...........................................................................................................####............####
###.........................................................................................................####.......##....###
###....................................................#####................................................#####......##....###
####..................................................######.................................................#####............##
#####....................................##...........#####..........E........................................#####...........##
#####.....................................#..........###.......................................................####............#
#####...........................................................................................................##............##
#####..........................................................................................................................#
###...........................................................................................................................##
###............................................................................................................................#
##............................................................................................................................##
##........####....................................................................................................#...........##
##.......######.....................................................................####...........#.#..........#####........###
##.......#######.........................###....................................#.########.........###.......########.......####
###....############.........##################......#.#.#.####...........#.#################.#.#.########################.######
################################################################################################################################
