################################################################################################################################
###########################.................................................................................................####
#######################................###...##########...................######........#####......##########..........####.####
###################...........................####.####...................#####..........###........###......................###
####...###########.............................#....####......##..........#####...............................................##
###.....####...##.....###.....##....................####.....###..........#####......###......................................##
###......##...........####...###........###..........##.......##.........#######.....###.....................................###
###..................###########.......#####............................#########....###.....................................###
###................#############.......#####...........................##########........................##..................###
###...............##############.......####.....................###..###########.........................###.................###
####..............###############......####......###.........###############................###..........###.................###
####..............#######...#####......####......####.......###############.................###.............................####
####...............#####.....####......####......#####.....########..##.....................###.............................####
###................#####.....###.......####......#####....#####.............................................................####
##..................####......#........#####.....#####....####...............................................................###
##...................##................#####.....####..............................................................##....##...##
##....................................######.....####..............................................................###..###...##
#....................................######.......####...............##..................................###.......###..###...##
#....................................#####........#####.............####................................#####............##...##
##....................................###.........#####.............####................................######................##
###...............................................#####.......##....####................................#######...............##
####...............................................###.......####....##.................................#######..............###
#####............##..........................................####............###..............#####....#########........#....###
#####...........#####.............###........................####...........#####.............###################......###...###
######..........######...........#####.......................#####..........#########...........##################.....###...###
#######...#.....#####............#####........................####.........##########............#################......#....###
########.###...####.............#######.................###....####........##########............###..###########...........####
##...######....###............##########...............####.....###.........########.............##....#########............####
##...######....###............##########...............####.....####..........#####........................##...............####
##...#####.....####...........##########..............####.......##............####........###.........................###...###
##....###.......########.......#########...............##......................#####......#####........................###....##
#................########.......########........................................#####.....######...........##..........###....##
#...............##########.......######.........................#................#####....######..........####........#####..###
#............##############......######...........#............###..........###...#####..#######.........#####........#####.####
#...........###############......######...........##.........#####..........###...#############.....#########..........####.####
#...........##############.......#######....#.....#.........#####..................###..#####....##########.............###.####
##..........####..#######........########..###..............#####........................###....##########..............###.####
##..........###.......##........##############...............####................................########.......##......###.####
##.........#####................##############......##.......#####.............................................####....####.####
##........######.................######..#####.....####.....#######...###......................................####....####.####
##.......#######...................###....###......######################......##.....................#.........##..........####
###.....#######...........................###......#####################......#######................###.....................###
####....######........###................###.......####################.......#######................###.....................###
####....####..........###...............####......####....#############........#####..................###....................###
####.....##............##...............####.....####.........##########..............................###....................###
####....................##..............####....####...........#####..###.................##..........###.......#.............##
####...................####.............####...#####...........####....###...............######......####......###............##
####..............#########..............##....#####............###....####...............#######....####......###...........###
#####............##########....................######...........###....####.................######..####........#............###
#####............#########......................######..........###....####..................###########.....................###
####..............#######........................#####..........###....####........#..........#########.......................##
###...............................................###............#......###.......###.....##...########...##..................##
##.......................................................................##.......###....####...######....###.................##
##.......................................................................##.......##.....####....####.....####................##
##.....................##.....S..........................................................####.....##........#.................##
###........###........######..............##.............###.............................#####................................##
###.......#####......########............####..........#####.....#......................######...............................###
###......######......#######.............####.........#######...###.....................#####.............................#.####
###.....######......#####.....##..........##.........########....###....#................###.............................##.####
####....#...........####.....####....................#######.....####..###.......#....................##..................#.####
####...............####.....######....##.......#....########....##########......###...................##..................#.####
####...............####.....#############.....###...#######....##########........#.......................................##.####
###.................##......#############....####...#####......##########........................................##.....###.####
##..........................#############....####....###........#########.......................................###########.####
##..........................##############..######....##.........#######..................##...................############.####
##...........................#####################....................................######..................#############.####
##..............................#################....................................#######..................#####..######.####
##.......##............###..................#####...................................#######..................#####....#####.####
##......####......#########......###############..................##................####....................######......###...##
##......####......#########.......##############...........##....###................####....................######.............#
##......####......#########........####.########..........####..####.................##......................#####.............#
##.......###......#########.........##...########......#######..###............###..........##................###..............#
##........#........#######..............#########.....#######....##.........#######........####...............................##
##....................####...###.........##..###......#####......###.......########.......#####..........................##.####
##.....................##...#####.............##.......###........####.....########......#######........................###.####
##.........................######............###..................####......######......########.......................####.####
###........................#######...........###...................###......######......#####.......##.................####.####
###.................###.....#######..........##.............................#####........###........###................####.####
##.................#####....########.........##..............................###....................###..........##......##.####
##.............#########.....########........##.....................................................####........####......#.####
##............##########.....#########.......###..............................................##....#####......######.......####
##.............########......###...###.......###............##...............................####....#####......#####.......####
##.....###......#######.............##......###............####.......................##.....####.....####.........#.........###
##....####.......######.....................##.............####......................####....####.....###.....................##
##....####.......######.....................................##.......................####.....###....####..............###....##
##....###........#####...............................................................####......###..######............#####...##
##.............#######................................###...........................######.....############....###....#####...##
##............#########..............................#####..................#......#######.....############....###...#####....##
##............############.............#.............#####.....#####.......###.....#######....##############...##....#####....##
##...........#############............###.............###.....#######....####.......###......##################......####.....##
###.........############..............###....................###...#########.................##################.......##......##
###........############..............###....................###.....########.................#################................##
###.......############...........######....................####.....########..................#####..######...................##
###.......####...####...........#######....................####.....###########................###...####.....................##
##........###.....###............#####.....................###.......##########............##................................###
#........................###.....####.....................###........##########.....###...####..............................####
#......................######...####.....................####......##########.......##########.....##.......................####
##....................##############....................#####.....##########........##########....####..##..................####
##....................##############...................######....##########..........########....#############..............####
##...................#####.#########...................#####.....##########...........######.....#############..............####
#......##...........#####...########....................##.......#########....##......##..........############............#.####
#.....####.........######....#######..........#...................######....#####.................########................#.####
##....####........######......######.........####..................####....#####..................#######.......###.......#.####
##.....##........#####.........####.........######..................##....###.....................######.......######.....#.####
##...............####....................########.......##................##.......................###.......#########......####
##................###...................######.........####..............###...............................############......###
##................####.....###..........####...........#####.............###..............................#############.......##
###................####...#####..........##............######............###..............................#####...########....##
####...............###########.................##......#######.................................E...##......###.....########...##
#####..............#########..................####.....#######...................................#####.....###......######....##
#####..............########..................######...#######...................................#######....####......####....###
#####....#..........######...................######...####................##....##..............#######.....##..............####
####....###..........#####............####..########...##................####..####.............########....................####
###.....###.....#.....###.............##############.....................####..####..###........########....................####
##.....####....###.....................############.......................##....##..######......#########...................####
##.....####....####......................########...............#...................#######......#########..................####
##......####....####.............##.......####.................###..................#######..........######.................####
##........##.....###.............####........................####....................######...........#####.................####
##.........##....................####......................#####.................###.######...........#####.................####
##................................###.....................#####................#####..######.....#...#######.........###....####
##........................................##..............#####...............##############....###...######........#######.####
##.......................................####.............#####................#############....###.....####.......########.####
##.......................................#####.............####.................############....##......###.....###########..###
##........................................######.................................##########....###...######....########.......##
##........................................########...............................##########....############...########........##
###................##.....####...........#############..........................############..#############..##########......###
#######################..######.....###################...#####.....###.....############################################..######
################################################################################################################################
