################################################################################################################################
##########.............................#######.################....##############.........######################################
###.#..#.................#############.#####......###########......############...........#########################.#.#.########
###.....................####.#########..............#######.........##########.............#####.#.##############..........#####
##.......................#......######...............######........###########.............###......##############...........###
##.......................#........####.................###.........############...........####.......############............###
##................#.................#..................####.......#####......###..........###..........#.#.#######.....#......##
##..............###.................#...................##.........###.......###..........##.................#####.#.#####...###
##............#####.....................................###........###.........##............................############....###
##..........######.....................................###...........#........###.............................#######.......####
##.........#######...................#.#...............###.....................##............................########........###
#..........#######...................#.#..............###...................................##...............########.......####
##........########..................##.##..............###.................................####.............##########.......###
#..........#######..................##.#..............###..................................###..............###########......###
##........########.......###.........#................###..................................###..............###.....##........##
#..........#######......###............................##...................................#.................................##
##........########......###..................##.......###.........................##...........................................#
##........#########.....###.................###........###........................#...........................................##
###.....###########....####..................##......####......................................................................#
###.....############....###.................###......#####....................................................................##
#####.#########.####...####.................##......#####......................................#.#.#...........................#
#############...#####..####..................S.....#######..............................############..........................##
###########......###...####.........................######..............#..............#############........#.#.#.............##
########..........###..###..........................######..............#..............############.......#####.#............###
######............########..........................######..............#......................####......######.##............##
####...............######............................####.......................................###.....#######.#.............##
####...............#####.............................####.......##...............................###.#.########.#..............#
##..................####..............................#.........#.................................#############.#.............##
##...................#.............................................................................########.#.#................#
#..........................................####...................................................#######.....................##
##.................................#......#######..................................................#####......................##
#..............................#######....#########...............................................######......................##
##.................##......##########.....#########..................................#............######.....................###
##.................###....#########.........########.................................##..........######......................###
###...........#...####....########................#......................###.....................#####........................##
####.........####.####....#######........................................###.#...................####........................###
#####........#########......#####.........................................######..................##..........................##
#####.......###...###........####...........................................##.#.............................................###
#######......##................###..............................###...........................................................##
#######.....###...............####.............................####................#####.#....................................##
#########...###................####............................###................#########....................................#
#########...###................####........................#####..................########...................##...............##
###.#.##.....#..................##.......................#####............#.......#...####..............#.#.###................#
###.............................#........................#####..........####............#.............#########...............##
#......................................................######...........#####...................#....#########.................#
##.....................................................######..........######..................###...###..####......#.........##
##...................................................######...........########.................###...#.....###.....###........##
####.............###..................................#####..........#########.............................###.....##........###
####.............###.................................#####..........###########............................####....##.......####
#########.........###..................###.............####..........##########............................#####..###......#####
##########.............................#####...........####............#########..........................##########......######
##########......................######.#####.............###.............#######..........................##########......######
#########......................#####.....####.............##...............####............................########.....########
#########......................######.....###...............................................................#######.....########
#########......................#####......###.................................................................#######.##########
##########.#.#...................#####...###..................................................###.............##################
##############....................####.#####..................................................###.............##################
############.#......................#######........#..........................................####............##################
##########............................###.........##...................................##......####...........##################
########...........................................##.........................#........#........###...........##################
#######...........................................##..........................##..............................########......####
######................##.......###................####........................##.............................#########.......###
#######..............###.......######...........######................#........##............................#######..........##
######..............####.......#####.#........#########..............###....................................####.####.........##
######...............###........##...........#########................####..................................##...###..........##
#####................###......................###.#.#..................##.........................................##.........###
####..................####...................####........................##.......................................#..........###
####..................####....................#............................#........................#......................#####
###..................#####...................###.........................#####.....................##......................#####
###..................####....................###..........................#####....................###...................#######
###..................#####...................####.........................######...................##...................####.###
####...#..............####...................###..........................######....................##.......................###
####.#####............#####...................#...........................#######...................###.E.....................##
###########............#####.............................................#######.....................###.#....................##
###########.............#####..........................................#######.........................####..................###
##..#######...............####........................................#######..........................#####.................###
#.....#####.................##........................................########...........................####...............####
##...#######..........................................................########.............................##...............####
#.....#######.........................................................##########............................................####
##....#########...................#...................................##########............................................####
##......#########................###..................................#######.###...........................................####
#.........#######................###..................................######................................................####
##...........######...............##..................................#####.........................#.......................####
#..............#####..............#...................................#####........................#.#####..................####
##...............##...................................................####.............................###..................####
#.....................................................................####.............................##.........###.........##
##....................................................................####.............................##........######.......##
#....................................................................######............................##.........#####........#
##...................................................................######...........................###.........#####........#
##...................................................................#####............................###..........####........#
#.....................................................................##..............................####..........###........#
##.......................#######......##...............................................................###..........###.......##
#.......................#########....##...............###..............................................####.........###.......##
##.....................#####.#####..................#####................................................##.........####.....###
#.......................###....##.....................###..............................###........................#####......###
##.....................####..........................###..............................####......................######.......###
##.....................####........................#....................................###.......####.........#######.......###
##....................######......................####.................................####.....#######.......#######........###
##.....................######....................###.................................#.####....########.......########.......###
##......................#####...................####...........#...................#.#.####...#########.....#########.......####
##......................######.............#########............#.................####...#############......#########.......####
##.......................####..............########............###...............####...#############.......########.......#####
###...................####..................#########...........#...............#######.###########...........#######......#####
##...................####......................############...#####............##################...............####.....#######
##..................####.........................##########...#####...........##################...................#.#.#########
##..................####........................##########....######...........#########...####......................###########
##......##.........####.............####........########.......######............#######...###.......................###....####
##......##..........###............#####......####.............#####..............######.............................###......##
##.......#..........###............#####......####.............#####..............######......................................##
##..................###............####.......###..............####................######......................................#
##...................#.............###..........#.............####........#.......#######....###..............................##
##..................................##............####........####.......##........##############..............................#
##.................................###............###.........##.........###......################..............#.............##
##..............................#####..............#.....................###.......###############.............#####..........##
##.............................######......................................#......##############..............######..........##
##.............................####.........................................#......############................#####..........##
##..............................###..........#..............................#......###########.................####............#
##..........................................###.............##..............##......######.#....................###...........##
##..........................................##..........#.####.................................................................#
##..........................................###.......########..........................................................#.#..###
##.........................................####.....#########...........................................................########
###.........................................####..##########...............................##.........................##########
##....................###..................################.......................#.......####.......................###########
####.....##..........####.............###..###############.........###........#.###........####......................###########
####.....####.......#######.........######################.......#####......#######........####.....##...............###########
######.####################.........#######################......#####.....#######.........####.....##.......###.....###########
#############################.....##########################...#########.##########.####.#######...#####...#######.#############
################################################################################################################################
