################################################################################################################################
###........................................................................................................................#####
###...................#####################..................#####.....######......#####.....######......########...######..####
##.....................############...#####..................#####.....#####.........###.......##..........#####....####.....###
##....................#############...####.....................#.......#####...............................######...#####....###
##....................############.....####............................####..................................###.....####...####
##..................##############.....###.............................####..................................#####.#############
##..................##############......#..............................###....................................##################
##.................#####.....#####.....................................###...................................###################
####................##.........###....................................###....................................###################
####...........................##.....................................###....................................###################
#####.............................................................................##........................####################
#####...................####......................................................###.......................#######.############
####....................#####.....................S..........###.................####........................######...##########
###.....................#####.................................##..................###..........................##.....##########
##......................#####................................###......................................................##########
#.......................#####................................###.....................................................###########
#.......................####................................###.......................................................###.#.####
#.......................####...............................####..............##....................####.......................##
#.......................####..............................####..............####..................#######.....................##
#...............###.#######..............................######............####..................########.....................##
#................###########..............#..............#############.#.#######.................########.....................##
#...............###########...............##......#......######################..................#######......................##
#................###.....###..............#.......##....#######......##########..................########....................###
##..............####......................#.....####...................##.#.#....................########....................###
#................##.............................####...............................................#.#####...................###
##..............###..............................####................................................#####...................###
#................###...............................##..................................................####........#........####
##...............###...................................................................................###........###.......####
#.................##....##......................................................................................######......####
##.....................###.........................................................................................##.........##
##.......................##.....##.............................................................................................#
##.......................#......##.............................................................................................#
##.............................###.......................######.......................................#........................#
##..............................##........................###........................................###.......................#
#...............................##....................................................................##.......................#
##.....................................................................................................###.....................#
#......................................................................................................###.....................#
##.......................................................................................................###...................#
##.................................####...............................................###................###...................#
####................................##.......#.......................................###...................#..................##
####........................................##........................................#.......................................##
#####........................................................................................................................###
####.............................................................................#..........................................####
####........................................................................######........................................######
###........................................................................######.......................................########
###.........................................................................####.......................................#########
##..........................................................................###........................................#.....###
##............................................................................................................................##
#..............##..............................................................................................................#
##.............##..............................................................#..............................................##
#.............................................................................####........#....................................#
##............................................................................#####.......##...................................#
##............................................................#..............######.......###..................................#
##............................................................##..............####.........##..................................#
##............................................................###............######.#......###.................................#
####..........................................................###.............########......##.................................#
###...........................................................###.............#########....#####...............................#
####..........................................................##...............#########....####...............................#
##.................................#...........................#...............##########..#####...............................#
##................................##.............................................#########...#.................................#
#..................................##...............#............................###########..................................##
##................................####.............##..............................########...................................##
##.................................####............##....................................###..................................##
###................................####............##....................................##...................................##
###.................................####...........##.....................................#...................................##
###..................................##............##....................................#....................................##
##...................................###............#.........................................................................##
##.........##......................................................................................##.........................##
##.......#####........................##..........................................................###.........................##
###....######.........................##....................................#.###..................###........................##
###########.........................#####...................................#####.............................................##
#########...........................####.....................................###...............................................#
########.............................##.......................................................................................##
######.........................................................................................................................#
######.............................................................##........................................................###
####..................###..........................................##...........................##...........................###
####................####............................................#...........................##...........................###
##..................####........................................................................###..........................###
###.................##...........................................................................#...........................###
##.......................................................###..................................................................##
###.....................................................###..................................................................###
##......................................................####..............................................###.................##
##.....................................................####..............................................####.................##
#......................................................###................................................#...................##
##........................................###..........#......................................................................##
#........................................#####.................................................................................#
##.......................#...............######.................................................#..............................#
##......................####..............#####.................................................##.............................#
####....................####...............#####................................................#..............................#
#####....................####..............####................................................................................#
#####......................#...............####................................................................................#
####......................................#####................................................................................#
###.......................................####................................................................................##
##.........................................#..................................................................................##
#.......................................................##........................E...........................................##
#......................................................###.....................................................................#
#.............#........................................##.....................................................................##
#............###.......................................#.......................................................................#
#.............##....................................................................#.........................................##
#.............##...................................................................###.........................................#
##.................................................................................####.........##.............................#
##................................................................................####...........##............................#
###................................................................................####..........##............................#
##.................................................................................###.........................................#
###.........................................................#..................................................................#
##.........................................................###.................................................................#
###.........................................................###...............................................................##
##..........................................................###...............................................................##
###..........................................................###..............................................................##
###.....................................................................###..................#................................##
####.........................................##........................####..........#.#.#.####...............................##
###.........................................###........................#####.........##########................................#
###..........................................#..........................####..........###########.#...........................##
##...........................................##..........................####...........#############..........................#
##........................................................................###.............###########.........................##
##.......................................................................####..............###########.........................#
###....#######............................................................###...............###.#####.........................##
###.....######...........................................................###......................####.........................#
###.....####.............................................................###......................###.........................##
###.....####............................................................###.......................#####........................#
##......##...............................................................##......................######......................###
###...#####............................................................................#.........#######.....................###
###...####.........................................#..................................####......########...................#####
############..................................#.######.......................#.......######.....#########..................#####
############.#.##...........................#################..............#####....########..############...............#######
###################.#.####.#.#..#.........####################......##.#.########.########################.#.#.#################
################################################################################################################################
