################################################################################################################################
###################################..............................................................................###############
###..#############################......###########................................###########.....####..####.....###...########
##....###########..##..#########....................................................#########.............###............#######
##....######.###........######..........................................................#####.............###..............#####
#....######...#.........#####............................................................####.............##................####
#....######..............###.........................................###.................#####..............................####
##....#####.....................###................................######................#####.............................#####
###....####....................#####...............................######................#####.............................#####
###....####.......##...........####.........##.....................######................#####.............................#####
###...####........##...........##..........####.........................................######..........##..................####
##....###........###.......................####...S..........##........................#######....#.....##..................####
##....###........####.......................##...##.........####.......................########..###..............###........###
##.....###........###...........................####........#####......................############...........##.#####.......###
###....###......................................####....#...######......................##########............##.########....###
####............................................###....###...######.....................#########...................######...###
####...................................................###...#######.....................#######.......................##....###
###.................................##.................####.#########.......##............#####..............................###
##................................####..................#############.......####............##..............................####
##.....#.........................#####...........###....#########..#........##########........................##.##........#####
##....##.........................#####..........#####....#######............###########..........##..........###.#####.....#####
##.....#..........................###.........#######....#######.............##########..........######......###.#####.....#####
##...........................................#######......######................######............######....###...####......####
##...........###............................#######........######................#####...............####....#...............###
##...........###........#..................########..........#####...............####.................###....................###
##............#........###.................########...........####..............####...................#.....................###
##.....................####.....................##.............####............####.........................................####
##.....................####....................................######..........####.......................#..............#######
##.....................####..............................##....#######..........##.....#.........#.......###............########
#...............####....##...................#...........###....########........##.....##.......###......###............########
#..............######.......................###..........####.......#####.......##.....#........###......###.............#######
##......##.....#####.........................#............##.........#####.......................#.......###...............#####
##.....###.....###....................##..............................#####.............................#####...............####
##.....###......#......................#..............................#####.............................#####.....#####......###
##.....###...........................................................######.............................#####....#######......##
##......##.....................##....................................######..............###........##...###.....#######......##
###.....##....................####........................###........######........##########......####..........#######......##
###########..................######.............##.......#####.......#####.........###########.....####........#.#######.....###
###########..................#######...........####......######.......####..........##########....####........##.#######....####
###...#####..................########..........####......######.......#####.........##########....###.........##.######....#####
##.....###...................#########........#####......#####........######.......###########...####..........#.###.......#####
##..........................####..#####......#####........##...........#######....############...####....##......#.........#####
###.....................#######....####....#######.........................####...###########....###########.................###
###.....................######.....###....#######...........................#################.....##########..................##
####....................######.....###....######....................###.....#################.....########....................##
####....................######....###....######...##...............#####....#######........###....######......................##
###...............#....######....###....####.....####..............#####....####............###..#######......................##
##......###########....#####....###.....###......####..............#####....###.............###########.......................##
#.....############.....####....###.....####......####........###....####....##..............###########......................###
#....############.......##......#....#######......###.....#######....###...###.....###.....###########...###.................###
##..#############...................#########......##....#########...###..####....#####...###########....###................####
###########..#####...................#...#####.....###..##########...########.....###################................#.....#####
##########....#####.......................###......###..#########....#######.....#############...####...............###...######
#########.......####...............................##...####.#........#####......###########......###................###.#######
#########........####............................##.....####...........####......##...#####......####................###########
########..........###..........................####....................####...........###.......####.................###########
##...###........................####..........#####....................###............##.......####..................###########
##...####.....##................####.........######...................####............##.......####..................###########
##..######...####................###..........####...................######..##......###......#####..................###########
##..######....##.....................................................##########......##.....#######............#.#..############
##...#####...........................................................##########............########.........####.###############
##....##..........###................................#................########.............#######.........#####.###############
##................###.................########......###................######...............#####..........####..###############
##................###................##########.....###.................######..............####...........###.....#############
##................###...............###########....#####.................########...........###.....................############
##.................##..............#####..####.....#############.........#########...........#.......................###########
##.................................####....###.....##############........#########....................................##########
##................................####...............###########.........########.................###.......................####
##..............................######................##########........###...###..................#........................####
##..............................#####..................#########......####.....#.............................##..#####......####
##..............................................##.........#####.....#####..................................####.######.....####
##..........##.................................###..........#####...#####.................#####.............####.#######....####
##.........###..................................##..........#####...#####.................#####..............###.########...####
##..........#.....##.........................................###########..................#####........##....###.########...####
###..............####...##............##.......................########....................###........####...###.#...#####..####
######...........####..####...........###.......................######.....................###.........##.....##......####...###
#####.............##...####.....###..#####......................#####.....................####.........................###....##
####....................##.....############........##...........#####..................#######..........................##....##
###............................################...####..........#####.................#########...............................##
###............................#######################..........####.......####.......########................................##
##............................#######################............##.......#####........###...................###..............##
##.........##..####..........##############..#######......................#####..............................###..............##
##.......#############......############.....#######......................#####..............................###..............##
##......###############....############......######...##..................####.....................######...####..............##
###.....##############....#############......#####...####................####.......##............##############...............#
###......############.....#############.......###....####................###.......###............##############.#.............#
###.............####.......#######.####..............####.................#.........##.............#########.....#.............#
###..............###........#####...###...............###...........................................#######......##...........##
##...............####...............###................##............................................#####.......###..........##
##...............######.............###........................##................................................####.........##
##..............#######.............###........................##..........#.........####........................####.........##
##..............#######.............####.......................##.........####......######.......................###..........##
##.........##..####.................####..................................#######...######.....................#.##...........##
##........########...................##....................................#######...####......................#.##..........###
##.........#######..........................................................######...####.....................##.##.........####
##.............###...................................###....................#####.....##.....................###.#.........#####
##..............###................................######..................###...................###......######...........#####
###.............######............................#######..................###...................####....######............#####
###.............######........#..................#######..................#####..................###############............####
###......############........###................######...............##########...........##......##############.####E.......###
##.......###########.........##.................######......#.......###########....##########.......############.#####.......###
#........############........##.................######.....###......###########....##########.........##########.######......###
#........###..########...........................#######..####......###########....##########...........########..##############
##.......##.......####...........................############.......##########.....###########............#####....#############
##......###........###...........................###########........######.........############............###...........#######
#.......###.......................................#########........#####..........##############...........###............######
#.................................................#########........####...........##############..........#####...........######
##............#.........................................###........#####.##.......##############..........######...........#####
##...........###.......................###...............###........########.......#############...........######...........####
##...........###.......................###................####......########.........#######.####..........######............###
##...........###...........................................###......########..##......#####...####.........#####.............###
##............#.............................................##......#######..####.....#####....###.....########..............###
#..................................................................#######...#####....#####.....#.....#########.............####
#.................................................................#######...#####......#####...........#######.....#.......#####
#............................................##.........#.........###......#####........####...............###....###.....######
##............................##...###......#####......##........###.......####.........####................###..####.....######
###...........................#########.....#####...............####.......####.........#####...............#########......#####
###............................########......####...............####......#####.........#####................#########.......###
###............................########..........................###.....#####..........#####....................######.......##
##..............................#######...........................##....#####..........#####......................######......##
##....................###........#######..........................###...####...........#####......................#######.....##
#....................#########....#######.........................###..#####............#####....................#########....##
#....................#########.....######.........................##..#######............####....................#########....##
#.....................########.....######.........................#...########....###....####....................#########...###
##.............##.....########.....######....##......###........####..#########..####....#####..##....###.......###########.####
######.......#####...#########....########..####....#########..#####.#################..##################....##################
#########...################################################################################################.....###############
################################################################################################################################
