################################################################################################################################
####################.#.#.#.#.#.#....#######################.....#.#.#.####################.#.#.#.#####.......######.......######
####.....#####.#.#...................##############..####.............#####.......#######........###..........####..........####
##.........#.........................############....#####..............##..........###........................##............###
##....................................############.....###.............##..........####.........................#............###
#.....................................###########......####.............##.........##...........................#..............#
##.....................................###########......####............#.........###............##............................#
##.....................##..............##########.......#########.#..............###...........#####...........................#
##....................####...............########.........#######.###............##............#####...........................#
###..................#####...............########...........#####.###.........................#######........................###
##...................####.................#####.....#.........#....###........................##.####........................###
##...................####...................###....##..............####......................#.....#........................####
##....................#............................####............####......................##..............................###
##........#.##......................................###............####.....................##..............................####
##.......######......................................#######.......###......................###..........#...................###
###.......######......................................######.......##.......................###.........##...................###
###.........####........................................####......##........................#####.......####.................###
####..........###....................###...............###........##........................####........##########.....##.....##
###..........####...................#####......###.#.#.###........##.......................###...........###############......##
###..........#####..................###.......###########................................................###############.......#
##.........#######............................##########..................................................############.........#
#..........###########.......................###########..................................................############.........#
#.........############......................#####.#.##........#...........................................########.#..........##
#.........########.###................#.#...#####.............#...........................................##..####.............#
#..........######....................####...####..............##..............................##.........###...................#
#..........#####...................######...####..............##...............##............########..........................#
#............###...................######....###.............##................###............########.........................#
#................................######......###............###.................#............##########.......................##
#...........................########.#.......####..........###..........................##.#...#.######.......................##
#........###................######...........####..........###....................#.#.######......#####......................###
#.........###................######...........####.........##.........#.#.#.....#############......####......................###
#.........####.................####............###...................########.#.#############.......####.....................###
#..........#####...............######...............................################.....###.........###.....................###
#............###.................####...............................##############...................###.....##..............###
#.............###...............######..............................############......................###....###............####
##............###...............####................................###########............................#####...........#####
###...........#####............#####.................................############........................#.#####...........#####
####..........#######........#####......................####.........############........................########........#######
#####.........########......#######..................########.........#############......................##########.#.#.########
####.........#########....########...................#######...........############............#.........###################.###
#####.........#######.....########...................#####..............#####....####.........###.........#################....#
####..........#####......########....................####...............###.......###.........#####.......#################...##
###.............#.......########......................##...............####........###........#.###........#########.#.###....##
###.....................####.####................................###.#.##.......................####.......#########........####
##.............................##................................########.........................##.......#######..........####
#............................................S..................########..........................##.........#####..........####
##.......................................................##......#######................#....................###.............###
#.......................................................#####....######................#.....................................###
##....................#.................................#####.....###.................###....................................###
#................########.............................########..................#......##.....................................##
##.............###########............................#######...........##.....###.....###...................................###
#.............#############..........................#######...........####...###.......###..........#........................##
##............##############..........................######............###....###.....#####.........###.....................###
#............##########.#.#####.......................####..............####.####.....#######........####....................###
##............#######.....#######.........#...............................########..#########..........#....................####
#.............#####........#####.........###.............................#######....#########..............................#####
##..............###.......#######.......####...............................#####.........##...............................######
##.............###.........#####............................................##................................###.........######
###.............###........######.....######.................................................................####.........######
####...........###.........#####......#####..................................................................#####........######
####...........###.........######....########................................................................######.......######
####..........####........#######....###########............##................#...............................#####......#######
####..........####........######....##############.........####.............###.................................###......#######
###........######........#####.......#####....####..........###..............###.............##.........................########
###........######.......####........######....####..........#####............##..............##..........................###.###
##.........####........#####.........####.......#............######..........................#..........................####.###
###.......###.........####............###.....#.#............######............................#.#......................###..###
##.........##........######.............#...####..............#####............................#####..................#####...##
###.......###........#####..................####..............####............................######..................###......#
####......##........#######..................###..........#.....#.........###.................####.............#.########.....##
#####....####.......#######.....###......................##...............###................###..............##########.......#
#####....#..........#######.....#####....................##..............###.................###...............########.......##
#####...............######......#####.................................##.....................##..................#####.........#
####................######........####...............................######.................####...................##.........##
###................######..........####...............................####................######...............................#
##................######............###...............................#####..............#########............................##
##................#######............###................................#................######.###...........................##
#................#########...........###..................................................##....###...........................##
##................###.#.##..........###..........................................................###..........................##
##................#.....###.........####...............................#........................####..........................##
###.......................##......####................................##........................#####.........................##
###.......##.............############..##.............................###.......................#####.........................##
####......##.............###########....###..........................#####......................######.........................#
####.....####..........############....######..................#......####....................................................##
####.....###...........############....########................###....######...................................................#
####....####.........#######.#.####......######........##........#.....#####................#.................................##
####.....##.........#####......####.........####.......##..............######.....###.#.....##.................................#
###................#####.........##..........####........................####.....#####......#.#.............##...............##
###................###.........................##........................###.......#####.....####............#.................#
##................####.........................###.....#.#................###......####.....#####...........##.......###.......#
##................###...........................##.....#####......................#####.....#####...........##........###......#
#.................####.........................####....######................#.#.#####......#####..........###.......#####.....#
##................###.........................####......#####................#########.......######........####.....######.....#
#................####.........................#####.......#.#................###.#.##........########.....######...#######.....#
##...............###.........................#####..........#..................................######.....#############.#......#
##...........................................######.........#..................................###.#......#.###########........#
####.........................................######.........#...........#.......................##............#######.........##
####...........................................######..................####....................###...........########........###
####............................................#######..............########...................####.#........#######......#####
####...................................#..........#####..............##.#######................########......#######.......#####
###..................................#####..........###.............##....#####.................#######.......######.......#.###
###................#..................####................................#####.#.##...........####..........######...........##
###...............###.................#####...............................####...####...........##...........#####............##
###................##......##...........##.................................##.....###.........................##..............##
###...............###......###.............................................##.....####........................................##
####...............##......##.....................................................####........................................##
####..............###.............................................................#####....#...................................#
###................##............................................................#####....###.................................##
###..............................................................................#####....##..............................######
##................................................................##.............####.....................................######
##.....................................##........................###.............####...................E.............#.########
##....................................###........................###.............##.................................#####..#####
##.....................................###......................###..............##.................................######.#####
##......................................#........................#..............##....................................##.....###
####..........................##.....................##.........................###.........................................####
#####........................###...............#.#.#.##.........................##...................###.....................###
######.......................###...............#######..................###.....###...................####..................####
######......................###................#######..................###......#.....................###........#..........###
######......................###................######...................###.......#.............................#####.......####
####.........................#..................###.....................###...................##..............########......####
####.....................................................................#........###........###.............##########....#####
##.................................................................................###.......................#########.....#####
##................................................................................####.......................#######........####
##........##................................###....................................####.....................................####
##......#####..............................#####.......######.....................######......................................##
##......####.........#.#..................########.#.#.########...................#######....................................###
####..########.#.#.#######.#.#.#.#.####.#.#############################.........###########.#.#.####.....###.................###
################################################################################################################################
