################################################################################################################################
#####...#####.....#####...#####.........####...##########..###.......##########...#####..##############.....########....########
####.......................###............................................................##.............................#######
####.......................##...............................................................................................####
#####.....................###...............................................................................................####
#####.....................###........................................................................................##.....####
####......................##.........................................................................................##.....####
####......................##................................................................................................####
####......................###...............................................................................................####
####......................####...............................................................................................###
###........................##.................................................................................................##
##........................................................................................###.................................##
##........................................................................................###.................................##
##..................................................................#.........................................................##
###.................................................................###.......................................................##
####.................................................................##.......................................................##
####..........................................................................................................................##
###............................................................................................................................#
##....................###......................................................................................................#
##...................####......................................................................................................#
##....................##..........................................#...........................................................##
##................................................................##..........................................................##
##................................................................#...........................................................##
##............................#................................................................................................#
##...........................###...............................................................................##..............#
#.............................#...............................................................................####.............#
#.............................................................................................................####............##
#..............................................................................................................##.............##
#............................................................................................................................###
#..........................................................................................................................#####
#..........................................................................................................................#####
##....................................................................................................................##...#####
##................................................###................................................................####.....##
###..............................................####.....................##.........#...............................####......#
###...............................................##......................##........####..............................##.......#
##........................................................................###........####.....................................##
#..........................................................................#..........###.....................................##
#......................................................................................##.....................................##
##............................................................................................................................##
##......................................###...................................................................................##
##.....................................######........................##.......................................................##
##......................................######.......................###......................................................##
##....##.................................#####.......................###......................................................##
##...####..................................##.........................###............................#........................##
##..####...........S.................................##...............######........................###.......................##
##..####............................................###...............######........................###......................###
##...##.............................................###...............####...........................#.......................###
##.....................................................................##....................................................###
##............................................................................................................................##
##............................................................................................................................##
##............................................................................................................................##
##........................................#...................................................................................##
##...#...................................###..................................................................................##
##..###..................................####..............###................................................................##
##.......................................#####.............####...............................................................##
##.......................................#####..............###...............................................................##
##......................................####.................##..........................................##...................##
#......................................###..................................................#............##...................##
#.....................................####................#..........###...................##.................................##
#....................................####................###..........#........................................................#
#....................................###.................###...................................................................#
#....................................##.................###...................................................................##
#.......................................................###...................................................................##
##......................................................###...................................................................##
##......................................................###...................................................................##
##......................................................###...................................................................##
##.......................................................#....................................................................##
#.............................................................................................................................##
#.............................................................................................................................##
#.............................................................................................................................##
##............................................................................................................................##
##............................................................................................................................##
##............................................................................................................................##
#.............................................................................................................................##
#...............................................#..............................................................................#
#..............................................###.............................................................................#
#..............................................................................................................................#
#..............................................................................................................................#
#............................#..........................................................#...........##.........................#
##...............###........###........................................................###..........#..........................#
###..............###.........#.........................................................###....................................##
######..................................................................................#........................#............##
#######.....................................................................................E...................##...........###
#######..........................................................................................................#...........###
#######.......................................................................................................................##
##...#.........................................................................................................................#
##.............................................................................................................................#
##...............###...........................................................................................................#
##...............####..........................................................................................................#
##................##...........................................................................................................#
##.......................................................................................................................#.....#
##......................................................................................................................##.....#
##.................................................................##....................................................#.....#
##................................................................####.........................................................#
##................................................................#####........................................................#
##.................................................................#####.......................................................#
#...................................................................###........................................................#
#..............................................................................................................................#
#..............................................................................................................................#
##............................................................................................................................##
##.........................................................................................................................#####
##........................................................................................................................######
##....................................###..................................................................................#####
##....................................####...................#..##.......#..................................................####
###....................................####.................#######.....##..................................................####
####.....................................#...................######......#..................................................####
####...........................................................###...........................................................###
####..........................................................................................................................##
###...........................................................................................................................##
##............................................................................................................................##
##............................................................................................................................##
##............................................#####........................##..................................................#
###..........................................#######.......................##..................................................#
####..........................................#####........................##.............##...................................#
#####....................................................................................###..................................##
####...................................................................................#####..................................##
##....................................................................................#####...................................##
#.....................................................................................####....................................##
#.....................................................................................###.....................................##
#............................................................................................................................###
#...........................................................................................................................####
#..........................................................................................................................#####
##......................................................................................................................########
##.....................................................................................................................#########
##..............................................................................................................##....##########
###...#####.......................##.........#####......................................................###...##################
#############...###...#######..#######......##############..######..###############..###########...#############################
################################################################################################################################
