################################################################################################################################
##################....##########..##############################################################################################
########...######......########....##############......#####............#####.....###################################..##...####
###..##.....####.......########.....############........###..............###.......#################################.........###
###....................########.......##########........###.......................##################################.........###
###....................#######...........######.....#..####.......................##################################.........###
###...................####.........................#########........#............###########.....##.....############........####
###..................####..........................###########.....###............#####......................########......#####
##..................####..............##............##########.....###.............###............................####.....#####
##..................####.............####............#########......###.............#..............................####....#####
###..................####............####............#######........###........................##.....#............####.....####
#######...............####...............#####.......######.........####......................####...###...........####......###
###########............#######...........######.....#######.........####......................#########............####.......##
############...........########.........###################.........####.......................#######..............###.......##
#############...........#######.........##################....###...#####..............#.......######.........................##
###....######............#####.....###...#################....###....######...........##.#.....#####..........................##
##.......###.......###....###.....#####......###......#####..###.......#####..........####....#####...........................##
##..................#............#######......#........########.........###............##....######...........................##
##.............................###########...#.........######...............................########..........................##
##...................S.........###....####..###........#####................................########..........................##
###....................................#####.#.........####.................................########....###.....#............###
###....................................####............#####................................###..##.....####...###..........####
####......................##..........####.............######................................#..........##########.........#####
####.....................####.......######..............###########......................................########..........#####
####.....................####.....########..............###########.......................................######..........######
####....##................##.....##########..............##########........................................#####..........######
###....####......................##########...............########.........................................######..........#####
###....#####....................###########.................#####..........................................#######...........###
##......#####..................###########...................####..........................########.......#########..........###
##.......###...................##########....................###........##...............##########.......#########..........###
##..............................#########.....................#........####.............##########.........#######...........###
###..............................#######..........#....................#####............#########...........................####
###.......................##.......####..........###...................######...........########...........................#####
###......................####.......###..........###....................#######..........######...##.......................#####
##.....##................####.....................###....................#######.........######...##...................#....####
##.....###................##.......................###....................#####..........#####........................####..####
##....#####........................................#####................................#####...........#.............#####.####
##...#######.......................................#########............................####..........####.....##......#########
#############......................................###############......................###........########...####.......#######
############........................................##############.......................#........###############.........######
#######...................#.......##.................#####.######.............................##################..........######
######...................####.....###................####....###.............................#######...########..........#######
###.......................####....#####.............#####....................................######.....#######..........#######
##................###......###....######..........########...................................######.....########..........##..##
##...............#####......###....######.........#########............#.....................#######.....########..............#
##......###......######......##.....############......######..........###.....................#######.........####.............#
##.....#####......######.....###.......#########.......######..................................######..........####...........##
##....#######......######.....##........#######.........######...................####..##......######...........####.........###
##....########........###......##.......####............#######.................##########.....######...........######......####
##....##########.......##................##.............#######.................##########.....#####......###..########.....####
###...###########......##...............................#######............###...#########...............##############.....####
###...############.......................................#######........#.####...#########...............##############......###
###....####...####..................###..................########......########...#######................##############.......##
####....##......#...................####................##########......########..####.................#################.......#
####................................#####..............###########.......#######..###................###################.......#
###.................................#####..............###########.......############................##################.......##
##............##....................####.....................######.##...############........##.......######....#####.........##
##...........#######................####......................#########...############......####........####.....###..........##
###...........#######...............###........................########........#######....######........####.....###..........##
####..........#######................#............................#####............############.....##..####.....####.........##
#####.........########.............................................####.............########.......##########.....####.........#
######.........#######..............................................###....##........######........###########....#####.......##
######...........#####..............................................###...####........######........###########....####.......##
#####.............###.......................###......................#########.........######........##########....####.......##
#####.............##.......................#####.....................########............####.........#########...####........##
######............##.......................#####...#.................#######..............###.........#########...####........##
######.....................................####...###................######................##..........#########..####........##
#######............................................#..................#####................###..........########...###........##
#######...................................................#...........#####..##............####..........######....###.......###
######...................................................#####........####..####...........#####..........####...............###
####...............##....................................#######.....####....####...........###.............................####
###...............####...###..............................#######...####......###...........................................####
##............########...####.................##..........#######...###.......###................................###...E.....###
##..........#########....######..............####........####..#######....#######...............................#####........###
##..........#####........#######..........#######.......####....######...#######.......#........................#####.......####
###.........####..........######.........#######........####.....#####...#######......###........................###.......#####
######.....................#####.........####............##.......####...######.......####...##............................#####
#######...................................##.......................##................#####..#####..........................#####
#######...........##..............................................................########...#####.........................#####
#######.........####.............................................................#########....#####.........................####
#######.........####.................###.........................................########......####..........................###
######..............................#####......###.............##.................#######.......###...........................##
###..............................#########....#####...........####.................######.......##............................##
##...............................#########....#####.........#########...............####.......###............................##
#................................##..#####.....####........###########..............####.......###............................##
#.....................................####.....###.........###########...............##.......####...........................###
##......................##............####.....###..........##...######......###............######..........................####
##....................#####...........#####...#####.................###.....####............######........##................####
###...................#####...........##############.................###....###.............#####........####................###
####..................####...........###############..................###..###...............###.........#####...............###
#####..................##............###############..................#######........####................######..............###
#####.....#................................######..........##...###..#######........######...............#######............####
#####....###......##........................####...........################.........#######........##....#######........########
#####.....#......####.......................####...........##########...##...........########.....####..########........########
#####............####.......................####.............#######....................##############..#########.......########
######............##.......................####................####........#####..........############..###########......#######
######..................###....###.........###..................##........######...........##########....##..###..#.......######
######.................#####...###........................................######...........#######........................######
###...................######....##...................###..................###..........##########.........................######
##........###........######.....###...##...........######...........................#############................##......#######
#.........####.......####.......#########.........########.......................################...............####.....#######
#.........####........##........########...........########.....................#################...............#####....#######
#..........##....................#####.................####.....................#################................####....#######
##...............................####...................###.....................################..................##.....#######
##...............................####............................................######.....###..........................#######
##.....##.........................####.........####..............................#####...................................#######
###..#####.................##......####....#########............................#######...................................######
#############..............###......###....###########.........##..............#########...................................#####
##############....##......#####.....###....###..########......####.............##########..................................#####
##############...####.....#####.....###..........########.....####..............#########..................................#####
#############....#####....####......##...............####......####................#####............................###.....####
#######..###....#######....##.........................####......###.........##.....###.............................#####.....###
######....##....#######................................####......##........####...###..............................#####......##
#####.....##....########................................####...............####...###............##..........##....#####......##
####............########.................................###................##...####...........####........####...#####.....###
###..............########......####......................###.....................####...........#####.......#####..#####....####
###...............########....######.....................##.......................##............######......#####..#####....####
###................#######....#####......................##....##................................#######.....###...####.....####
###................######......###......................#########..........##.....................#########........####.....####
###................#####...............................##########.........###......................#########.......####.....####
##.................####..............#................########..........#####.....##.......###......########.......###.......###
##................####..............###...####........#######..........####......####......###......########.......###.......###
##................###...............##...#####.........##.............####.......####.......##.......#######.......####.......##
##.................#................###.####.........................####.........##..................#####........####......###
##....##............................#######..................##.....######............................#####........#####..######
###..####..............###...####..#########..###.....###..###################........#######........#######......##############
###########........############################################################......###########################################
################################################################################################################################
