################################################################################################################################
###.........................................................................................#.##########################.....###
#.......#######...................#######...#####............####......###......#########.......########....###.#.####........##
#.......######...................#######......#..............####......####.....########...........#.#......#.#...............##
#.......#####...................#######......................####........##.......#####.....................#.................##
#........##....................########......................####.........#.......###...........#...........##................##
#.............................#########......................####..................##.........####..........###..............###
#.................#............########....................#####...............................##...........####.............###
#................####.........#######............###........####.............................................#####..........####
#................####..........####...............####.......#................................................#####..........###
#................#####........####................#####.......................................................#####..........###
##................###.........####..................###........................................................###............##
##................#####......#####..................###.......................................................#####............#
##.................####.#.#.#.###....................##................................................#.......###.............#
##...................######.#.#.....................###.............................##......####.......##......####............#
##....................#######........................#..............................###..##.#####..............###............##
###...................######.........................#..............................#####.#.####................###............#
#######...............######.........................................................#....#.###.................##............##
#########............####...................................................................#...................###............#
###....##...........####.........................................................................................##...........##
###.....##.........#####.....#............................###...................................................####...........#
##......##.........####.....###.....S.....................###.......................##...........................##...........##
##......##.........####.....##..........#................####.......................#.........................................##
##......##..........#..................####..............####......................##.........................................##
##......##..............................####.............####.................................................................##
###.....##..............................####.............#.##...................................##............................##
###....##...............................####.....................................................#............................##
#####.........#......##.................####...................................................................................#
#####........#####.######................##.........................................................................##.........#
#####.........###########...........................................................................................##.........#
####..........#############.................................................................................###................#
####...........###..#.#####..................................................................................###...............#
##..............###...######..................................................................................###.............##
##.....#...............####.....................................................#.............................####............##
##....####.............####..........................................###.......###.............................####..........###
#.....####...........#####.........................................######......##............................#####...........###
##....###............###.........................................########......###...................###.#.#.#####..........####
#......#.............#..........................#..............##########.......#...................############............####
##.............................................###............###########.......##..................##########..............####
#............................##...............................###########............................#######................####
##.........................####...............................##########........###..................#####...................###
##.......................#####.................................#########.........###........#.........###....................###
##......................####...................................###...#..........#####.......##........###.....................##
###.....................#.......................................................####........#.................................##
###.............................................................................#.............................................##
###................................###.......................................................................................###
##.................................###.......................................................................................###
##...............................####.#.................................................#..........................#####.....###
#................................####.................................................####..........#.........................##
##.............................####...................................................##...........###..............E.........##
##...........................######...............................................................###..........................#
##...........................#####................................................................###.........................##
##...........................#####......................................#.#......................###...........................#
##....................#.....####........................................####......................###.....................#...##
###..................####.................................................##.....................###......................##..##
###...................###............########.#................................#........##........###.....................######
####...................###...........############.................##...........##.......##.......####.....................######
####.............##.....####.......###############................###..................###........##......................######
###..............###...............###############................###...................#.................................#.####
###..............##...............###########..###.................#..........................................................##
##........##########...............#....####..................................................................................##
##........#########...........................................................................................................##
#........#######.#................................................##..........................................................##
##.......#####...................................................###.#.###....................................................##
#.................................................................########....................................................##
##..................................................................#.###.....................................................##
#................................................................................................#...............##............#
#...............................................................................................##................#...........##
#...............................................................................................##.............................#
#........................................................#....................................................................##
#........................................................##....................................................................#
#..........................................................................................................................#.###
#.......##.............................................................................................................#########
#........#.........................................................................................................#############
#.................................................................................................................##############
#................................................................................................#.................######...####
#................................................................................................#.#.................###....####
#..............................................................#.#..............................##.#.....#...........#.#.....###
#.............................................................#####..............................#.##..###.................#####
##............................................................######.............................#.#...##..............#########
###...................................................#......#######..................................###...............########
####.......................#..........................#.......######..................................##................########
####.......####...........#####.#.....................#.#....#######...................................##................#######
####.......#####..........########....................#.##...########.................................##..................######
###.......######...........#######......................########.#####.................................##..................#####
###........####.............#####.......................######....######..............................##....................####
##..........#.................###.......................######.....#######.............................##....................###
#........................................................###........#######........#.#.................##.....................##
#............................................##.......................###..........#####...............###.....................#
#............................................#####................................######................#.....................##
#............................................######................................######......................................#
#..............................................####................................######.....................................##
#.............................###.............####...................................#####............................##.......#
#.............................##.......................................................###...........................###......##
#..............................#....................................###...............................................#........#
#..................................................................#####......................#...............................##
#.................................................................#####.....................###.##............................##
##...............................................................######.....................###.###...........................##
##..............................................................#######......................##.####..........................##
###.............................................................#######.......................#.#....###.....................###
##..............................................................#######............................#####.....................###
###..............................................................#######.............................#......................####
###..............................................................#######...........................................#........####
###..............................................................########....................#....................####.....#####
###.....................................................##........###........................###..................#####....#####
####....................................................###......####.........................###........#........#####....#####
####....................................................##.......##.....................................##........#####.....####
#####...................#...............................###......##................................................####.....####
##...#.................##................................##.....###................................................####......###
##....................###................................###....###.................................................###......###
#.....................##.....##.#.........................##.....##.................................................####......##
##...................###.......###........................##.....##..............###.................................####.....##
#....................##........####.......................###.....#..............###..................................####....##
##..................###..........###......................##......##............####.................###...............###....##
#...................##..........#####..........#.#.###...####......#............####................#####.............####....##
#.................####...........#####.......##########.####.......##...........####................#####..............##.....##
#.............#...####..........#######################.####.......##............####...###..........###.....................###
#............#########..........###########.#.#########.###........##............##########.#.................................##
#.............##.#####.........##########......########.###.......................#########.##...............................###
#..................###..........##.#.#.........########.##........................#########.###...............................##
#..................####........................########.##........................#########.###..............................###
#.....##............###.......................#########.##........................#######...####.............................###
#.....#####...........#......###...............########.####.....................#######.....###.......#......................##
#.....######.................#####............#########..####....................######.....#####....#####....................##
#.....#######.................####.............#######.....####................########.....#####...########...................#
##...#########....####........######.#.#.....##########...#######.......################..###################.......#........###
########################.#.#.#############.#.##########.#.##########.##########################################.#.#####......###
################################################################################################################################
