################################################################################################################################
##############.....................................................................................###..####################..##
########...##......##############......############################..........####.......##########..............###............#
#######.............########............####..###.........######..............##............#####..............................#
#######..............######.............###................####.............................#####..............................#
#######........####......#..............##.................###............##................#####.............................##
######.........#####.......................................##.............###........##.....#####............................###
######.........#####..........####.........................#...............##.......####.....###........................###..###
######..........###............####.......................##........................#####.............................######..##
#####...........................####......................##...........#............######...........................######....#
####............................####......S...............###...##....###...........########........................######.....#
####............................####............###.......########....###...........#########......##..............######.....##
#####..........................#####............####.......#######....###............########......#....##.........######....###
#####.....##..................#####..............###........#####....####............#######............##........######.....###
####.....####........##.......#####..............##.........####.....###.............#######...........####...#########.......##
####.....####.......####.......###..........................####......#.............########...........###############........##
####......##........#####...................................#####...................#######............##############.........##
####.................#####..................................######..................#####.............###......######........###
####..................####...................................######.................####..............##.........####........###
####.........##.......###......................................#####...............####..............###..........##.........###
###.........####.....###..........................................######.........#####...............##########..............###
###.........###########...........##...............................######.......#####................###########............####
###.........########..............##.....#..........................#####......######.................##########...........#####
###........########.......######........###..........................####.....#######.....................#####...........######
###........#######........########.....####............####..........####.....#######.....###..............###............######
###.........######.........#######.....###............######..........##.......######....#####.....###....................######
#............#####.........######.............##......#####......................#####..######.....###...................#######
###............###.........#####.............####.....####.........................##########......###................##########
##.......................######.............#####.....####..........................#######.........#.................####...###
##......................#######.............######....#####....##.........#..........####.................####........##......##
##......................######.............########...######...##........###............................########..............##
##.....................######.............#########....#####...##........#####........................###########.............##
###..........#.........#####..............########......###....##.........#####......................############............###
###.........###.......######..............####.................##..........####......................###########............####
####.......####.......#####................##.................###...........##........................##########...........#####
#####......###.......#######...#..............................####.........................................#####...........#####
#####......###.......############.............................####..........................................###.............####
#####.....####......############..............................#####.........................................###.............####
####....#######.....##########.................................#####.......................................#####............####
####...#########...##########...................................#####.........##....................##.....#####...........#####
############..###############........................####........####........####..................####...######..........######
###########....##############.......................######.......####........####..................####...######..........######
########........#############.........##............#####.......#####.........###.....###..........###.....####...........######
#######..........###########.........####............####......#######.................#...........##......###.............#####
######.............###...##.....#....#####............##......#########.....................................................####
######.........................###....####....................#########......................................................###
######.........................###.....####...................########.......................................................###
######.........................###......####.......##..........######..................................##................#######
######..............####......###........###......####...........###..........................###.....#####.............########
###.##..............#####....###..........#.......#####...................#####..............####.....#######............#######
##..................#####....####................#######.................#######............####......########..............####
##...................###........................########................########...........####........#######...............###
##.......###.................#######...........#########................########.....##.....##..........######...............###
##.......###................########...........############.............######......####................######..............####
##........##................########..........##############............#####.......#####..............######...............####
##...........................#######.........###############............#####.......#####.............######....#####........###
###...........................######........###...##########.............####......#####.............######....######.........##
####..........................#####........###....####..#####.............###......#####.......#.....######...#####............#
#####.........................#####........###.....##....####.............###......#####......###.....####....####.....##......#
######.......................#####..........#..............#.............####......#####......###.....####...######...####.....#
#######...................#######......................................#####.......######......#.....####...##############....##
########.................#######......................................####.........######............###...##############....###
########.................#####........................####.....##.....###..........#######...........##...##############.....###
########.................###........................#######...####....##............######................########..###.......##
#########......................##........#..........###############..###..............####.....###.......#######..............##
##########....................####......###.........###...#########..###......................####.......######...............##
##########...................#####......###................#######...####.......##...........#####......#######....##.........##
##########.........#####.....#####......###.................###.......##.......####.......########......######....######.....###
#########.........######.....####......#####.................#................#####......#########......#####....#######.....###
########..........#####......####......######................................#####.......########.......####.....#######......##
########..........#####.....####......########..............................####..........#######........###....#######.......##
#######..........#######...#####.....#########.............................####............#######........###..#####..........##
#####...........###############......#########.............................###..............######........########...........###
####.........##############...........#######...............................................######........######............####
####........#################.........######................................................######........#####.............####
#####........################.........######............##..................................######.#.......####..............###
######..........#############.........######...........###...................................#####.#.......####...............##
######...........###..#######........#######..........####...................................#####.##.......##................##
###..............##....######........########..##......##............................##......#####.##.............####.......###
##...............##.....##...##......#############..................................####.....#####.#.....#.......######......###
##...............##..........###....##############........................########..####.....###........###.....#######......###
##...............###.........############.#######.........................#########..##.................####....######.......###
##...............####.......############...#####..........................#########......................###....###........#####
###..............####.......###########....####.................##........#########....##.................##....###......#######
###..............####........##.....##....####......###........######......#########..####......................##.......#######
###.............#####....................####......#####.......#######......#...#########................................#######
###..........#######.....................###.......######.......#####...........########..................................######
###.........########.....................##.........######......................####.......................................#####
##.........##########.........................###....#####............##.......####.....................###................#####
##........#############......................####.....#####..........######....####....................######.............######
##.......################...................#####......###..........########....###...................########............######
##.......######...#########................#####....................########....###....................#######............######
##........###......#########..............######.....................#######....###......................####..............#####
##.................################.......#####........................#####....###.........................................####
###.................#####..########........###..........................####....###.........................................####
####................####.......####......................................##.................................................####
#####................###...................................................................................................#####
########..............###...............................................................................................########
###..####..............###.............###...###########...............................................................#########
##....###..............####.....#.....##################..........########..............................................########
##....###...............####...###...###################.........##########...............................................######
#....####................###..####...##################..........##########...............................................######
#...#####...##...........###..###....#################............#########...........................................##########
#...####...####..#.......########....#################...............######..........................................###########
##...##....########.....########......##########.######...............######.......##..............###..##...........###########
##.........##...###....#########............##....######....#........#######......####......###....########..........###########
##.....................#########..................######...###......#########.....####......######.########...........##########
##......................########..................#####....###......###########...###.......######.#######..............########
##........................#####...................####......###.....#################.......######.###...................#######
##....#####................####...................####.......###.....################........#####.##....................#######
###..#######................####.................######......####....#######..########..##...#####.##....................#######
############.................#####............##########......##.....######....###################.##..............##...########
############..................#####...........###########.............######....##################.##.............##############
############..................####.............###########..............#####.........##..########.###.............#############
###...#####...........####.....##..................#######...............#####.............#######.###..............############
##...................######.........................#####................#####.............#######.###...............###########
##..................#######.........................####.................####...............######.####...............####...###
###.................######..........................###...................##.........E.......#####.#####.....##.......###.....##
###..................####..........................###.......................................#####.#######..####......###.....##
###............#.....####.........................###....####................................#####....###########......#......##
###...........###...######.......##...............###...######...............................####......##########............###
##.............#####################...............##...######........................###....###........########............####
##..............#######################.................######.......................#####...###.........######............#####
###....##.........######################................######........................###...####.........######...........######
###...####.........####################.................######..............................#####........#######.........#######
##########.....##.######################...............########..######....................#########.....############..#########
###########..############################......####...########################............###########...########################
################################################################################################################################
