################################################################################################################################
###..#######################################.###################################################################################
##...#############################..######....####.....######..###...#######......################............######...#########
##...#######......###############............#####......####..........#####........######......................####.....###...##
##...######........#############...........########......###...........###..........####........................###...........##
##....####.........#########..............#########.......##.........................##..........................###..........##
##..................#######...............#########........##.....................................................##..........##
##...................#####....####.........########........###...............##...............................................##
##..................#####....######........########........####.............####.............................................###
#..................#####....#######........########.........####............####.............................................###
#.................#####.....#######.........######...........##.............####...........#................................####
##.......##.......####......#######.........###......#####..................###...........###..............................#####
###......##.................########.......###......######.........................####...###........##....................#####
###........................##########......###......######........................######............#######.................####
###........................##########......###......###.................#.........######............########.....#...........###
##............##..........###########......##.......##.......#.........###.......###..###............#######....###...........##
##........#######.........##########.......##......###......##..........##.......##....#.................###.....#............##
##.......###########.......#####...........###....#####......#...................##..........###..............................##
##.......###########......................#############.........................###..........####.....................##.....###
##.......####..#####......................############..........................##...........#####...................####...####
##........##...............................##..######...........................................#...................#####...####
##..................................##.....##....####...................................................#..........######...####
##.................................####....##.....##....................................#....##........###.......#########..####
##...............##................####....###.........................................###..####.......###.......#########...###
#...............####................##.....####.......................................#############....###.......#########...###
#...............####........................###.......................................##############....##.......########.....##
##...............####........................###......................................##############....###......######...E...##
###..............#####......................#####......................................####.....####.....##.....#####.........##
###..............#######.................#########......................................##.......###.....##.....####..........##
###..............########.......##......#########..........##..............##....................####....###....###...........##
###.............########....######.....#########...........##...##........####..................######...####....##...........##
##.............###..........######....##########..........####.####.....######................########...####....##....##.....##
##..............#............#####...###########..........########.....#######.......##.....#########.....##.....##....#......##
##.............................###############...........#########......###.........####...#########..........................##
##..............................############.............########...................####...#########..........................##
###..............................###########..............##..##...................######.#####..####........................###
####.......#.....................###########................................##....############....###........................###
######....###.....................##########...............................####...###########......#.........................###
#############......................########........#........................##...############................................###
###..########........########......................##...........................######..####..................................##
##....#######.......##########.....................##...........................#####....##...................................##
##.....######.......#########......................##..........................#####..........................................##
##.....######.......####...........................##...........................####..........................................##
##......####........###............................##......###....................###...............###......................###
##......####........##............................###......####...................###..............#####....................####
##......####.....................................####......#####......##..........###..............######..................#####
##......####...................................#####.......######....####...#....###...............#########..............######
##.....####....................................####........######....####...##...###.....###........########.............#######
#......###.....................................####........######....####...########......#...........#####.....##.......#######
#.....###......................................####.........####......##....#######............................###........######
#....####......................................####.........####.............#####..........................######.........#####
#...######.....................................###..........###..............#####..........................###.............####
#...##########.................................###...........................####...........................##................##
#...###########................................###...........................####......................................#......##
#....#########.................................###..........................####..............###.....................###.....##
#.....#######..................................###..........................#.................###...............##.....###....##
##......###....................................####......................####.................###..............####....###....##
###.............................................####.....#..............####....................................####..####....##
####.............................................###....###.............###......................................#########....##
####............###..............................###.....................#.........................................######.....##
####............###..............................##.................................................................#####.....##
##..............####...........................##.....................................................................####...###
##..............#####..........................##....................................................#.....##..........####.####
###..###........#####............#########....###..............................##...................###...####...........##.####
#########........###............##########....####........###.................####.................#####.######...........#.####
########........................####....##....######......####................#####...............##############............####
###..............................##............######.....######...............####................#############..............##
##.............................................######......######..............####....................##..####...............##
#..............................................#######.....##########..........####.........................##......###.......##
#..............................................#######.....###########....##...#####...............##..............#####......##
##....................................################.......##########..####..#####..........########..............#####.....##
##......S...........................#################.........###...#########...###...........##########............#####.....##
##................................################............##....#########...##..............########............#####.....##
##...............................####...##########..........####.....########..###...............####...............#####......#
##..............................####........######.........#####.....#############...................................###.......#
##.............................#####........######..........#####.....############.....#......................................##
###...........................#####.......#######....##.......##.......###########....###....................###.............###
####.........................###.........#######....####.................########.....###...................#####............###
#####.......................###..........######.....####..................######.....####....................#####...........###
######...............##....####...........####.......##....................###.......#####.....................####.##........##
######.........###...##....####............##..............................###.......########..................########.......##
#####.........####...##....#####...........................................####......#########....#............#########.....###
####...........###..........####............................................####.......#######...###..........##########.....###
####.........................##.............................................####........#####.....#............#..#####.......##
###........................................................................#####..............................................##
###...###..............##...................##......##....................#####........................#......................##
###...###.............####................#####.....###...................#####.......................###.....................##
###....##............####.................####......##.....................####........##.............####...................###
###....##............###..................###...............................###.......###..............###..................####
##.....##.............#.....................................................####.......#...................................#####
#..............................###..........................................#######........................................#####
#.............................#####...........##..........###................#####.#..............##.....###................####
##............................#####..........####.........###.................####.#.............###....####.................###
##............................#####.........######.......###..........##.......###.##............###....##..................####
#..............................###.........########.....###..........####......###.####................##................#######
#..........##.............................#########......#........######......####.######...............................########
##........###...........................###########............#########......####.######...............................########
###.......###..........................############...........#########.......###........................................#...###
#######...###..........................############...........#########.......###.............................................##
#############..........................############...........##########.......##...............#..............................#
#############..........................##..#######.............##########.......##.............###.............................#
########...#......#.........................#####..........#......########...............................#....................##
####.............###......#..................###..........##........######...............................#....................##
###...............#......###..............................###...........................##....................................##
##.......................###..............................###..........................####....................................#
##.......................##......##.......................###..........................####....................................#
##......##.......................#.........................#..........................#####....................................#
##.....####..............................................................####........######....................................#
##.....####.............................................................####..........######..................................##
##....#####..............................##.............................####............#####.................................##
##...######.....#.......................####.................##..........####............####.................................##
#....#####.....##.......................######...............#.............#..............###...........................##.....#
#....#####.....##.......................#######............................................##...........................##.....#
##..######.....######....................#######............................................#..................................#
#########.....########...................########..............................###.............................................#
#####...##....#########..................##...######................#.........#####...........................................##
###......##....#...###.........................#####....##.........###.......######...........................................##
##.......##.....................................####....###.......####.......#######..........................................##
##..............................................###......#........#####.....########..........................................##
###........................................#.....##................###############............................................##
###.............###.......................###..........................##########.................###.........................##
####...........#####..........##...###...####............................#########................###.........................##
#####.........#######........##########..####.................##.........#########......###.......###.........................##
######........##########.....##########..#####...............###.........#####..##.....####...................................##
#######......############....##################..............####........#####.........###...........................###....####
#########################...####################............#####.......######........###.............####..........#####..#####
#################################################################################..#######.....###..############################
################################################################################################################################
