################################################################################################################################
################################################################################################################################
########...........#############################################################################################################
#####################################################################.##########################################################
#################################################################.........######################################################
###############################################################.............####################################################
##############################################################...............###################################################
#############################################################.................##################################################
#############################################################.................##################################################
############################################################..........E........#####################################.....#######
############################################################...................#####################################.....#######
############################################################...................#####################################.....#######
############################################################...................#####################################.....#######
###########################################################.....................####################################.....#######
############################################################...................#####################################.....#######
############################################################...................#####################################.....#######
############################################################.........S.........#####################################.....#######
############################################################...................#####################################.....#######
#############################################################.................######################################.....#######
#############################################################.................######################################.....#######
##############################################################...............#######################################.....#######
###############################################################.............########################################.....#######
#################################################################.........##########################################.....#######
#####################################################################.##############################################.....#######
####################################################################################################################.....#######
####################################################################################################################.....#######
####################################################################################################################.....#######
####################################################################################################################.....#######
####################################################################################################################.....#######
################################################################################################################################
################################################################################################################################
################################################################################################################################
################################################################################################################################
################################################################################################################################
################################################################################################################################
################################################################################################################################
################################################################################################################################
################################################################################################################################
################################################################################################################################
################################################################################################################################
################################################################################################################################
##########...............#######################################################################################################
##########...............#######################################################################################################
##########...............#######################################################################################################
##########...............#######################################################################################################
##########...............#######################################################################################################
##########...............#######################################################################################################
##########...............#######################################################################################################
##########...............#######################################################################################################
##########...............#######################################################################################################
##########...............#######################################################################################################
##########...............#######################################################################################################
##########...............#######################################################################################################
##########...............#######################################################################################################
##########...............#######################################################################################################
##########...............#######################################################################################################
################################################################################################################################
################################################################################################################################
################################################################################################################################
################################################################################################################################
################################################################################################################################
################################################################################################################################
################################################################################################################################
################################################################################################################################
################################################################################################################################
################################################################################################################################
################################################################################################################################
################################################################################################################################
################################################################################################################################
################################################################################################################################
################################################################################################################################
################################################################################################################################
################################################################################################################################
################################################################################################################################
################################################################################################################################
################################################################################################################################
################################################################################################################################
################################################################################################################################
################################################################################################################################
################################################################################################################################
################################################################################################################################
################################################################################################################################
################################################################################################################################
################################################################################################################################
################################################################################################################################
################################################################################################################################
################################################################################################################################
################################################################################################################################
#########################################################################............###########################################
#########################################################################............###########################################
#########################################################################............###########################################
#########################################################################............###########################################
#########################################################################............###########################################
#########################################################################............###########################################
######################################.##################################............###########################################
###################################.......###############################............###########################################
##################################.........##############################............###########################################
#################################...........#############################............###########################################
################################.............############################............###########################################
################################.............############################............###########################################
################################.............############################............###########################################
###############################...............###########################............###########################################
################################.............############################............###########################################
################################.............############################............###########################################
################################.............############################............###########################################
#################################...........####################################################################################
##################################.........#####################################################################################
###################################.......######################################################################################
######################################.#########################################################################################
################################################################################################################################
################################################################################################################################
################################################################################################################################
################################################################################################################################
################################################################################################################################
################################################################################################################################
################################################################################################################################
################################################################################################################################
################################################################################################################################
################################################################################################################################
################################################################################################################################
#############################.##################################################################################################
#############################.##################################################################################################
#############################.##################################################################################################
#############################.##################################################################################################
#############################.##################################################################################################
#############################.##################################################################################################
#############################.##################################################################################################
################################################################################################################################
