################################################################################################################################
#########.#.#.#.#.#.#.#.#.####.######......#.#.#..#.#.#################.......######........#################......#.#.#########
#######..........................###.....................############........................######....#.##..................###
########..................................................#########............................###.............................#
#######...........................S.......................#######.............................####............................##
########...................................................###.................................###.............................#
####.####.................................................##..................................###...................###.......##
####...#...................................................#...................................##..................######......#
###..........................................................................#................###..................######....###
#####........................................................................###...............##..................###.#####.###
######.......................................................................####..............##........................#######
#####................................##........................................##...............#....##...................######
###..................................##.......................................####...................##.....................####
###..............##......................................##....................####...................##......................##
#...............#####..................................####....................####...................##......................##
##..............######................................#####................#....####...................#.......................#
#.........#.....######..............................######...............###.....####.........................................##
##.......###....####........#.......................######...............#.......####.......................................#.##
###......###.....#.........##........................####..........................#......................................######
####....###..........................................#####.................................................................#####
###########...........................................###..................................###...............................###
###########............................................###.................................####...............................##
##########............................................#####.......########...................#..........####...................#
###.######.......................................##...######......########................................###.................##
###...####......................................#############.....########................................###..................#
##......#.........................##............#############.......#####..................................###................##
##...............................####...........#############.......######...................................#................##
##...............................###.............######...............###.................................................######
###................................................#..................####..............................................########
###....................................................................##.............................................##########
####...........#.......................................................###...................#.......................####....###
###............###.....................................................###..................###.....................#####....###
###.............####...................................................####.................###....................####........#
##..............######................................................######................###...................#####........#
##................####................................................######................##...................#####.........#
##................#####................................................######...............#....................####..........#
##................#####....................................................##...............##....................#............#
##................####..............................#####..................................##..................................#
##................####..............................######.....................................................................#
###...............###..............................######......................................................................#
##...............####...............................####......................................................................##
##................###...............................###......................................................................###
#.................###................................#.......................................................................###
###................##.................................................#.......................#............##..............#####
###...............####.....................#.........................###.....................####.........###..............#####
#####...........#.###......................##........................###....................######.........##..............#####
#####.........#######......................##..............###........#.....................####..........###..............#####
#####.......########....................................#######..............................#...........####.............######
####........######....................................##########.........................................####.......############
####........##.#............###......................##########...........................................##.......#############
####.......................#####.....................##########...................................................########.#####
#####.......................###......................#########.....................................................#####.....###
#####.................................................######......................................................######......##
######..................................................##.........................................................####......###
#####.......................................................................###...................................#####.......##
####..............##........................................................###...................................####........##
##...............###.........................................................####................................####..........#
###...............###............................###..........................#..................................####.........##
##...............####..........................######............................................................###...........#
###..............###...........................######........................................#................................##
###............####.................#..........####.........................................##................................##
###..........####..................###..........#.............####............................................................##
##.........#####...................###.....................########............................................................#
##........#####.....................##....................##########...........................................................#
#.......######...............#............................##########...........................................................#
###..###.####..............#####.........................###.#.####............................................................#
##...#....................#####..........................###...................................................................#
###.......................#####..........................##....................................................................#
##.......................#####................##.........##..........................................................###.......#
###......................#####................###.........##........................................................#####......#
###.....................#####................#####..................................................................###........#
####...................#####.................######............................##..............................................#
####...................####.................########......................##.#####.............................................#
####....................##..................#########....................########..............................................#
##......................###................###########....................######...............................................#
##.....#...................................#####.####....................#######...............................................#
#.....####..................................##...####...............#....#####................................................##
#....###..........................................##...............###########.........................................#......##
#....###.........................................###................########.........................................####......#
#.....#...........................................#..................#######............................................#......#
#...............................................###...................#####....................................#...............#
#......................................................................##......................................##..............#
#..............................................................................................................#..........#...##
#........................................................................................................................#######
#........................................................................................................................#######
#.........................................................#.............................................................########
##....###...............................................####..............................................................#.####
#.....####..............................................###.............##..................................................####
##...#######.#.........................................##...............###...................................................##
#.....##########.........................##.......##...##..............###...................................................###
##..........#####........................##......##.....................###...................................................##
#.............####...............................###....................##....................................................##
##............####...............................##...........................................................................##
#..............####..............................###..........................................................................##
##............#####........................###.######.........................................................................##
#..............####........................###########....................................#..........####......................#
##............####..........................###############..............................####.......######....................##
#.............####.........................####......######...........##................######.......#####......###............#
###...........##............................#..........#..............#.....#...........######.......#######.....##...........##
##............##..........................#.#..............................###.........########......#######.....###...........#
#####.....................................#.................................##..........######........#######.....##..........##
##.............................###.......##..................................#..........######........#######......##..........#
##.............................####......##..............................................###...........#####.......##.........##
###.............................###......................................................####...........####...................#
###.............................####......................................................##............####..................##
####.............................##.......................................................................##..................##
####.....................................................#................................................##..................##
####....................................................###................................................#...................#
####....................................................###.............................................E..##..................#
####...................................................###.....................................................................#
##......................................................##.....................................................................#
##.............................................................................................................................#
##.............................................................................................####.........##.................#
##............................................................................................####...........#.................#
##.................#..............................................................##..........####.............................#
##.................###....................#.......................###............###..........#.#..............................#
##................####..................###..................####..##..........#.####..........................................#
##.................####................######..............#####............#########..........................................#
#.................#####...............#######..............###.............##########.............##..........................##
##.................#####.............##########...........####........##.#.###########............##..........................##
#..................#####.............####.#######.........##.........#################......................................####
##..................####............####...######........####........#####...###########....................................####
##..................####.............#.....######........####.........#####.############..................................######
##....................###..................######.......######..........#...############................................#.######
####.................####..................######........#######..........###############.............................##########
#####................######.####..........########......##########.........##############...........##...............###########
#######.#.#.####.#.################.#.#.#.#########.#.#.##########.......#####################....##########........############
################################################################################################################################
