################################################################################################################################
#####.....###################..#################################################################################################
####..........##############.......###############...################....#####.################..#####.......######..###########
####...........######...............########..###.....##############......###...##############....###.........####.........#####
###............######.................######..........##############............#############.....##..........####..........####
###.............#####...................#####..........#........#####..........#############...................##............###
###..............###.....................#####...................####.........#############..................................###
###.......................................#####...................##..........#############..................................###
###.......................................#####.S.............................##############.................................###
###......................................######..............................#################...............................###
###..........................##.........#######.............................#####..############..............................###
####.........................###.......########.......................##...#####....###########.........................#.....##
####.........................######....#######.......................###########.....#########.............#...........###....##
####.........................#######.......##........................############......######.............###..........###....##
###...###....................######..................................#############......#####.............###.................##
##....####...........###.....####.....................................#####..#####.......###.............#####...............###
##....#########......###.....###.......................................###....#####...................#########..............###
##...###########......###....##...............................................######.................##########..............###
##...###########.......###..###..............##...............##..............#######................##########..............###
###...#########........#########..#####......####.............##..............#######..............###########...............###
###....####............################......#####...........###..............######.............############................###
##......................###############.......#####.........####.....###......######.............###########..................##
##.......................############.........######........###.....#####.....######..............#########...................##
##..............####......##########...........#####........###.....#####....########.............#########...................##
###......#.....######......########.............####.......#####.....###.....#########.............#########..........##.......#
###.....##############..##...######......###.....###.......#######............#########.............#########........###.......#
##......###################...#####......###.....###......#########..............######.............#########........###......##
##.......##################....###...............####.....#########...............#####..............########.........#......###
#........#####.###########........................##.......########................##.....................##...###...........###
#........####...#########...................................########............................................#............###
#.......#####....#######.....................................########..............................#.........................###
##..##########....#####....................###...............#########...................###.......##........................###
##############....#####..................######...............########................#######......#........................####
#############.....#####.................#######...................###................########..............................#####
#############.....#####................#######.....................#.................########..............................#####
###########.......####................####............................................#######............##................#####
##########.........##.................###..............................##.........#......####............#######..........######
##########.............................#............###...............####.......###......###............#######.........#######
###########....................##...................###...............#####......###......###.............######.........#######
###########...................###...................####.....##........#####.....###.......#.............................#######
###########......#####.........##....................####...######......#####...####....................................########
###########.....#######...............................###...######.......##########..................###................########
##########......#######................................##....#####..........######............###########...............########
#########.......##..##........................................###............####....###.....############................#######
#########......##............................................................###...######...#############....##...........######
#########.....###...........................................................###...########.###############.#.###...........#####
##########....###...............#####.......................................###...#################..####.##.######.........####
###########...###............##########...........................................#################...##...#.#######........####
###########..####...........############....##....................................############..####...........#####.......#####
##########...####....#.....####..##############...................................###########....###............####.......#####
####...##.....##....###...####........#########....................................#########.....####..........#####......######
####...##................####..........#######......####............................#######......####.........######......######
####...###...............####...........#####.......#####.....##.....................#####........##..........######.......#####
####..#####..............####............###.........###.....####....................####.....................######.......#####
####..#####..............#####...............................######...................##.................##...######.......#####
#####..###................###................................#######....................................####...#####......######
#####.........................................................##..###..................................#####...#####.....#######
####...............................................................###................................######..######....########
###......#........................................####.............###..............................########.#######....########
##......###............##........................#######...........##..........####................################.....########
##......###............###.......................########.........###.........#####................#############.........#######
##......###............###.......................#########..###..####........#####.................############...........######
##......###.............##........................###################........####...................###########............#####
###....####.........................................####...##########........###.........................#######...........#####
############.........................................##.....##########........................###.........######............####
############....###.........................####............##########........................####.........##...............####
######...####..####........................#####.............##..#####.........................####.........................####
#####.....#########........................####..................####...................##......###.........................####
#####........###......................##....##...................###...................####.....##..........................####
####.............................##...###........................##....................#####....##....................##.....###
###.....................##........#...###..............................................######...###..................####.....##
###....................####...........###...........###................................######...####.............########.....##
####..................#####..........###.............#..................................####....######...........########.....##
####............###..######..........##.........................................................#######...........########.....#
####...........############.........###.......................................###...............#######............#######.....#
####..........#############........#####....................................######..............######.............######......#
###..........##############.......######...................................########..............####............########.....##
##..........##..###...####.......#######..................................#########...............##............#########....###
##.........##.........##........########..........................#......#########.......................####...#########....###
###........##.........#........########..........................###.....########.......................######..##########...###
######.....##................#######.............................###....####..##.......................#######...#########....##
#######....##...............#######......#.......................####..####...........................#######.....########....##
#######...####.............########.....###........##.............#########........######.............######.......####........#
#######...######..........########.....####.......####.............########......#########.............##..........###.........#
#################........######........####.......####..............######......##########.........................###........##
###..##############.....######..........###........##..........................##########...........................#......#####
###...##############....######.............................#####...............#######.......###.......##...............########
###....#############.......##.............................######...............######.......#####.....#####............#########
###......###########..................##..................##...................######.....#######....########..........#########
###.......#####...##.................###.......................................#####.....########...##########........##########
#####.....####....###...............####.......................................#####....########....###########.......#####..###
#######...####....####..............###....................................##########...##..........####...#####......##......##
#######...####....#####............###..........####............#.........###############...........####....####..............##
######...#####....#####............##..........#####...........###........#############............#####....####.............###
#####.....####.....####............#..........######...........###........##############...#.......#####...#####.............###
####.......##......####.......................####..............#........####################......####...#####.............####
###................####......................####........................####################......####..######.............####
##................######......##............####............#.............##...#############.......###...#######.....###....####
##.....##.........######.....####..........#####.....##.....##..................###########..............#########..#####....###
##....####.........######....####..........#####....####....#....................########.................###############....###
###..####...........#####....###............#####...####.........................###..##..................#####..#######.....###
########............#####.....#.............#####....###........................###.......................###.................##
#######.............#####...................#####.....#.......................#####.......................##..................##
######.....##........####...................####..............................######......................##..................##
###.......####........###....................##...............................#######.........#..........###..................##
##........####.........###..................................#####..............######......#####.........###..................##
##........####..........###...........................############..............#####.....######.........####.................##
##........####...........##.....#.....................######..####................###......#####.........#####................##
##.E.......###...........###...###..............##....#####....##..................###......#####.........####...............###
###.....................#####...#......##......####...####.....##........#..........###......#####....................###....###
#####..................######......#######.....####....##.....###.......###.........####............................######...###
######................######......########.....#####..........###.......##...........####.....#####...............########....##
######................#####.......#######.......#####.........###.......##...........#####....####...............##########..###
#####.................####.........######.......#####..........#........##............####....###................###############
####..................###...........####........####...................##...............##....##..................##############
###.............###..###......##.....##........#####.................####.....................##...................#############
##.........############.......##...............####.................####......................###...........##........##########
#..........####..####.........##...............####.......####......####.......................#...........####........#########
#.........####................##................##.......######.....####...................................#####........########
#......######.........................................#########.....####..................................#######........#######
#......######........................................#########......####....##..........................###########........#####
##......#####..........###.............#####.......###########......###########.............#.......###############.........####
#####....###....##.....####.........#########.....###########.......############...........###.....##########..####..........###
######.........####....####........#########......#########..........############..........###....##########....##............##
#######........#####...####........#########......########...........###############.......###....###########.................##
########......#######.######......##########.....##########....###..#################...#######..##############..............###
#############################...#############..#############..#######################################################..#########
################################################################################################################################
