################################################################################################################################
#######################################..###############################....####################################################
###.....###########.........#######........#######..####..##.#########..............#######....###....#####################..###
##.......####..###............####..........#####....##.......#######................###................#########..######.....##
##..............##.............###...........###...............#####.....................................#######....###.......##
###.............###..###.......###...........###.................##........................##............######...............##
###.............########........#...........####..........................................####...........######..............###
###..............#######....................###...........................................####.......##...#####..............###
###................###......................###.....###..............................##...####......####...###...............###
####.......####.............................##......###.............................###....###......####.............###......##
#####..########............................##.......###.............................###....####....#####............#####.....##
###############...........................###.......####..........##......#.........##.....####...#####............######....###
############...............##.............###.......####.....########....###.......##.......##...######.............####....####
###########................###.............##........###....#########....######....##...........#######.....................####
####.######......#.........###......##.......###.............########....#######...###..........########.....................###
###.....##.......##................####......####...............#####....#######...####.........##...####....................###
###..............#.................#####....#####.................##.....######.....######.............###.............###...###
###.................................#####..#######..........##............###........#####..............#.............##########
####.................................####..##########......####.........................##............................##########
#####................................###....##########....#####........................................................#########
#####......####.....................###......##..#####...#####..........................................................########
####......######...............#######............###########......##.............#......................................#######
###......#######.............#########............##########.......###..........####.....................................#######
###......######.............##########.............########........###..........###..................###.................#######
###......#####...............########..............#######..........###.............................####.................#######
####......####..................##...........##....######............###..........................######....###..........#######
####......#######...........................####....###..........................................#####......###...........######
####......#######..........................####..................................................####.......####.............###
###.......######............................##...................................##.............#####.......####..............##
###.......#####..................##.............#...............................####...##........#####.......###..............##
###........###................######............##............................############........#####.......................##
####...................##....########........................................#############.........#####.....................###
####.............###..###....#####...........................................#############.........#########.................###
####............#########....####....................##...###.................#############..##....##########.................##
###........#....#########....####....................###.#####.................#######..########....#########.................##
##........###....########....###....................##########.................#######...########....########...........##....##
##........####...#######....####....................#########..................######....#########.....#####............##...###
##.......#####....######S...####....................#######...................###.........########......##...............##..###
##.......#####....######...####.....................######....................##..........#########......................##..###
##.......#####...######....###.................##..#######....................#............#########....................###...##
##.......###.....######........................#############.................##.............#########..................#####...#
##.......##.......######.......................#####......#####..............##.............#########.................#######.##
##.................######.....................#####........####..............##..........############................###########
#.....................#####........##....###.#####.......................................#########............##....############
#......................######.....####...####.###........................................########............###...#####.#######
#........................#####.....###...###.............................................#####........##....###....####...######
#.........................#####....####..........#.......................................####........##########.....##.....#####
##..........................####..#####.........###......................................####........##########............#####
##............................##########.......####....###...............................###.........###########..........######
##..................#####.......############...####....###............###................###.........############.......########
##.................#######.......###################...####...........####...............###..........############.....#########
##.................########......####################...#########.....#####..............##............####.....#.....##########
##.................########......########.############...#########....###########.......###..........................####...####
##................##########....########...##########....##########..############......####..........................####...####
##................##########...##########..##########....#####..#################....#####............................##.....###
##.................##..#####...##########..#########......###....################...######..................##...............###
##......................###....#########...########.......###.....###############...#####..................####..............###
##.............................#######.....########................###############...####..................#####............####
##.............................######.......########..................#############...##....................#####........#######
##....##..##..####............#####.........##########....................#########.........................######......########
##...#############...........#####...........##########....................########....................####...####......###.####
##...#############....##....####..............##########......................######..................#######...##...........###
##################...####..####................########...............##......#######................########................###
########.......###...####..###.......................................###......########..............#########...............####
########..............##...##.......................................####....####..####.........##############...............####
#######.............................................................###....####....###........##############.................###
###.......................................####.....................###......###.....##........###....######...................##
##.......................................#####.....................###........................................................##
##.......................................#####.....................###.......................................................###
##...#.........###.......................#####.........######.......###...##.................................................###
##...##.......#####......................#####.........#######.......#######...............................##................###
##...........#######.....................#####.........#######.......#######.......###.......#............####...............###
##...........#######......................###...........#####.......####...........#####....###............####..............###
##...........########....................................####....######.............#####...####..####.....#####.............###
###...........#######...................................######...#####................###...###########.....####.............###
###................###...............##...............########...####..................##....##########.....####..............##
####................#...............####.............#########....###.........................####..##......###...............##
####................................#####............##########..#####........................###..........###................##
###................................#######...........#################.......###.............####..........###........##......##
##....###.........................#########.........#################.........#..............#####.........###.......####.....##
##....###........................##########........#################..........................####........####.......####.....##
##.....##........................#########.........################.....#......................###........###.........##.....###
##...............................#######...........#####......#####....###................................###...............####
###............#..##.......##.....######.......########.......#####....####..........................###...#...............#####
####..........#######......##......#####.......#######.......######.....###..........................###...................#####
####...........######......##.......#######....#######......#######.....###..........................##.....................####
#####............###.................######.....#####.....########......####..###...................###.....................####
#####.................................#####......##......########.......#########...................###...........##.........###
#####...................................................########.......###########.................#####.......#####..........##
###.....................................................###...........#############................#######....######...........#
##.................###.......................###......................##############...............########...#####............#
##................#####......................####......................#############......#.........########..#####...........##
##.....###........#####...............#......#####.........##............######.###......###.........#######...####...........##
##....######.......####..............###.......###.........##............#####........######.........######....####...........##
##....#########.....###.............####...................##........#########........######.........##.........##............##
##....##########....####...........####..............................##########.......#######.......###.......................##
##.....#########....####......#########................................########.......#################.......................##
##.........####......##......#########..................................######........################........................##
##..........###..............########..................##................####..........########..####.....#####.....###.......##
##...........##..............#######..........#.......########...........###..............####...........#######.....##.......##
#............##..............#######.........###.....##########.........####...............##............#######..............##
#...........###.............########.........###.....##########.........#####..............##.............######..............##
#.........#####............##########.......####....#####.####..........######............####...............##..............###
#........#####...........#############.....####.....####...###...........######...........####...............##..............###
#........#####...........#############.....###.......##.....#......###....#####..........######..............##.............####
##.......######..........############.....###.....................#####....###...........######.............####........########
###........########.......####...........####...................#######.................######....#####.....####.......######.##
####..........######...................#######.................########..................##......#######....###.......######...#
####...........#####..................########.................########.........................########.............#######...#
###............####....................###...........##........#######..........................#######............########...##
##..............##..................................####........##.........##.....##...............###............####........##
##..................................................####...................##....####............................####..........#
##.........................###..................##...##....................###..####......................##.....###...........#
###.........................#..................####........................########......................####...###...........##
###............................................####........................########......................####...###..........###
###...................................##.......#####..................##..########.....##................####...###..........###
##...................................###.......#####....###..###......###########....#####................##.....#..........E###
##..................................####......######....#########.....##########....######....................................##
###.................#.....##.......#####.....#######.....########.....##########....######..................###..........##...##
###................####..####.....######....########.....#########...###....####...######..................#####.........###...#
###................###########....######.....########....#########...##......####..######.................#######........##....#
###................############..######.......########....########...##.......###..######.........####...##########...........##
##.................##################..........########....######......###..........####........#######..##############......###
#...................###############............#########...######......####.........###........#########################.....###
#...................###############............##########..######.....######........###.......##########################....####
##..##..###.........###################....#######################.#############...####...###############################..#####
##############.....####################################################################################################.########
################################################################################################################################
