################################################################################################################################
#####.#.#.#.######################.#.#.#.#.#####.#.#.#.############....################.#.#.#.#.###.............#.#.#.#.#.######
###...........#####.......########...........#...............######......############........................................###
###...........#####........######...............................#..........########...........................................##
##..............#...........#####.............................................................................................##
####.........................####...............................................................................##............##
####..........................##................................................................................###...........##
######.........................................................................................................####...........##
#######.........................................................................................................##...........###
######.......................................................................................................................###
######......................................................................................................................####
#####........................................................................................................................###
######.......................................................................................................................###
######.......................................................................................................................###
########.....................................................................................................................###
#########.......................................................................................#.#..........................###
########.#......................................................................................######........................##
####.#.#.........................................................................................#####........................##
##.................................................................................................####........................#
##..................................................................................................####...............##......#
#..............................................................................#####.................###..............####.....#
##............................................................................#######..................#................###....#
#.............................................................................######....................................##.....#
###..................................................#.........................................................................#
###.#.###............................................#.........................................................................#
#########...................S........................##........................................................................#
########.......................................................................................................................#
######.........................................................................................................................#
####....................#........................................................................................###...........#
##.....................###.......#...............................................................................##............#
##.....................###.......##............................................................................................#
#......................####....................................................................................................#
##...................#####....................................................................................................##
#.....................###.....................................................................................##...............#
##...........................................................................................................###.........#....##
#.............................................................................................................###.......###....#
##............................................................................................................###........##...##
#...............................................................................................................#.......###...##
##......................................................................................................................###...##
#.......................................................................................................................####.###
#...........................................................#...........................................................###...##
#..........................................................####.........................................................####.###
#...........................................................###........................................................####...##
#............................................................####...........................###.......#...............######.###
#..............................................................##.............................##....#####............###########
#........#......................................................##............................###.########..........############
#.......####..........................................................................................................#.########
#........####...........................................................................................................########
#.........##..............................................................................................................######
#..........................................................##.............................................................######
#..........................................................##............................................................#######
#..........................................................###..........................................................########
#................................................#.........###...........................................................#######
#...............................................####.....#####.....#.....................................................#######
#................................................###.#.#.#####....##........................................................####
##..............................................#############......#..........................................................##
##...............................................############.................................................................##
###..............................................#....######..................................................................##
###.......................................#............####...............................#...................................##
####...................................................###.................................#..................................##
###.......................................#.....................................##.........#..................................##
###......................................##....................................###........##...................................#
##.......................................##.....................................###.......##..................................##
##......................................####......................#..............#.............................................#
##.....................................##.##.....................###..........................................................##
##....................................#...........................##...........................................................#
##.................................................................#..........................................................##
##.............................................................................................................................#
##............................................................................................................................##
#..............................................................................................................................#
#.............................................................................................................................##
#..............................................................................................................................#
#..............................................................................................................................#
#..............................................................................................................................#
##.............................................................................................................................#
##.................................................................................###.#.......................................#
###................................................................................######.................................#....#
###.................................................................................######...............................###...#
####.................................................................................####.....................####.......###...#
####..................................................................................####...................#####.......###...#
#####.................................................................................###....................####........###...#
####..................................................................................####....................#..........##....#
#####.................................................................................####..............................###....#
####..............................................#...................................###................................#.....#
####............................................#.##....................................................................##.....#
###........................................##########...................................................................#......#
###.......................................###########.......................................................#..................#
##.......................................#####.#.#####..........................................###.........###................#
##......................................######.....###..........................................###..........##...............##
#...................................#.#######...........................................E........#.............................#
##.................................##########..................................................................................#
#..................................##########..................................................................................#
##......#...........................#########..................................................................................#
##....###.................##.............####..................................................................................#
##.....#.................####.............###..................................................................................#
##.......................###...................................................................................................#
##........................##...................................................................................................#
###.............................................................................#.#............................................#
###.............................................................................#####.....................................#...##
###.............................................................................######....................................######
###..............................................................................###......................................######
##.........................................................................................................................#####
###........................................................................................................................#####
##...........................................................................................................................###
####.........................................................................................................................###
####...............................................##...............................................................###.......##
#####.............................................###.............................................................######......##
#####.............................................###...........................................................#########......#
#####............................................####..........................................................####.#.###......#
####............................................#####..................................................##.....#####.....#......#
##.............................................######......................................#...........##.....####.............#
##.............................................#####......................................###................#####.............#
##.......................................................................................####.................###..............#
##........................................................................................#...................###..............#
##......................###..............................................................##....................................#
##.....................####.....................................##.......................#.....................................#
##.....................#####...................................###............................................................##
##.....................#####....................................###...........................................................##
##......................####....................................###...........................................................##
##..............................................................###..........................................................###
###.............................................................###..........................................................###
###.............................................................##............................................................##
###................................###.........#..............................................................................##
##..................................###.......####.............##.............................................................##
#....###...............#...........#####......#####............#.........................................##....................#
#.....####.#.........#####..........#####....########........#####.....#####............................#####....#...........###
##..##########.......######.......##########.########......####################.#.#...................##########################
################################################################################################################################
