################################################################################################################################
################################################################################################################################
################################################################################################################################
################################################################################################################################
################################################################################################################################
################################################################################################################################
################################################################################################################################
################################################################################################################################
################################################################################################################################
################################################################################################################################
################################################################################################################################
################################################################################################################################
################################################################################################################################
################################################################################################################################
################################################################################################################################
################################################################################################################################
################################################################################################################################
################################################################################################################################
################################################################################################################################
################################################################################################################################
#######################################################################################............#############################
#################################################.................#####################............#############################
#################################################.................#####################............#############################
#################################################.................#####################............#############################
#################################################.................#####################............#############################
#################################################.................#####################............#############################
#################################################.................#####################............########.####################
#######################################################################################............########.####################
#######################################################################################............########.####################
#######################################################################################............########.####################
#######################################################################################............########.####################
#######################################################################################............########.####################
###########################################################################################################.####################
######################################################################################.####################.####################
######################################################################################.####################.####################
######################################################################################.####################.####################
######################################################################################.####################.####################
######################################################################################.####################.####################
######################################################################################.####################.####################
###########################################################################################################.####################
###########################################################################################################.####################
###########################################################################################################.####################
###########################################################################################################.####################
###########################################################################################################.####################
###########################################################################################################.####################
################################################################################################################################
################################################################################################################################
################################################################################################################################
#############################################################################..............#####################################
########.#######################################################################################################################
#####.......####################################################################################################################
####.........###################################################################################################################
###...........##################################################################################################################
###...........##################################################################################################################
###...........##################################################################################################################
##.............#################################################################################################################
###...........##################################################################################################################
###...........##################################################################################################################
###...........##################################################################################################################
####.........###################################################################################################################
#####.......####################################################################################################################
########.#######################################################################################################################
################################################################################################################################
################################################################################################################################
################################################################################################################################
################################################################################################################################
###############################################################################################################.........########
###############################################################################################################.........########
###############################################################################################################.........########
###############################################################################################################.........########
####################################################################.##########################################.........########
################################################################.........######################################.........########
##############################################################.............####################################.........########
#############################################################............E..###################################.........########
############################################################.................##################################.........########
###########################################################...................##################################################
###########################################################...................##################################################
##########################################################.....................#################################################
##########################################################.....................#################################################
##########################################################.....................#################################################
##########################################################.....................#################################################
#########################################################............S..........################################################
##########################################################.....................#################################################
##########################################################.....................#################################################
##########################################################.....................#################################################
##########################################################.....................#################################################
###########################################################...................##################################################
###########################################################...................##################################################
############################################################.................###################################################
#############################################################...............####################################################
##############################################################.............#####################################################
################################################################.........#######################################################
####################################################################.###########################################################
################################################################################################################################
################################################################################################################################
################################################################################################################################
################################################################################################################################
################################################################################################################################
################################################################################################################################
################################################################################################################################
################################################################################################################################
################################################################################################################################
################################################################################################################################
################################################################################################################################
################################################################################################################################
################################################################################################################################
################################################################################################################################
################################################################################################################################
################################################################################################################################
################################################################################################################################
################################################################################################################################
################################################################################################################################
################################################################################################################################
################################################################################################################################
################################################################################################################################
################################################################################################################################
################################################################################################################################
################################################################################################################################
################################################################################################################################
################################################################################################################################
################################################################################################################################
################################################################################################################################
################################################################################################################################
################################################################################################################################
################################################################################################################################
################################################################################################################################
################################################################################################################################
################################################################################################################################
