################################################################################################################################
##############...............#.######.........############.#.#.#..#.#...........##########...........#.#########################
#######..................###.#...####...........########..........................#######...............#############........###
###......................###......##.............................................#######.................#####.######..........#
##........................##......................................................#####...................####...###..........##
##................................................................................###............##......###...................#
#.......................................................................###......................###......###..................#
#.............................................................##......#####.......................####..####...................#
#............................................................####.....#####.......................###########..................#
#...........................................................#####....#####.....................................................#
#...........................................................#####.....##.......................................................#
#................................#####.....................######.............................................................##
##..............................######.....................######............................................................###
##.............................######......................#######..........................................................####
####............................#####.......................######.........................................................#####
######.........................#####.........................#####.........................................................#####
#####...........................###...........................###..........................................................#####
######.........................####..............##...........###.........................................................######
#####..........................####.............##............###.................................#........................#####
#####..........................####.............###...........###.................................#.......................######
###............................####.............##...........####.................................#...........#............#####
###.............................###............#####.........####..................................#.......####............#####
#.......................#......................####...........###.................##.......................#####.............###
##.....................###....................####.............##.................##.......................#####...............#
#......................####.................#####...............................####...........................#...............#
##..............#.#.#.####..................#####...............................####...........................................#
#..............###########..................######.............................######..........................................#
##.............##########....................#####..............................#####..........................................#
#...............#########....................#####.........###..................#####..........................................#
#.................######......................##.#.........###...................###..........................................##
##...............#######...................................####.................###........................................#####
#.................###.#....................................####.................#.........................................######
##................###.......................................####............#.###........................................#######
#.................###.#.###..................................##...........######..........................................######
##...............##########...............................................#####...........................................######
##...............########.#................................................#####...........................................#####
##..............#######.....................................................###............................................#####
##..............####.........................................................##.............................................####
#................#..........................................................................................................####
##.....#......................................#...................##..........................................................##
#......##.......................#............##..................####.........................................................##
##.....##......................##............#....................###..........................................................#
##.....###.......................................................###.......#...................................................#
##.....####.......................................................###....###.................##................................#
####.######......................................................###...###...................##................................#
###########................................................###....####.###...................###...............................#
#########.................................................###..........#.....................###...............................#
######..........##.......................................#####..............................####.............................###
#####...........##.......................................####..................................#.............................###
####.....................................................#####........##............................#.#.....................####
###.....................................##................####........###..........................#####....................####
##.....................................####..............#####.........#...........................####.....................####
##....................................######..............####......................................###......................###
##.....................................####..............####................................................................###
#......................................#####.............####.................................................................##
##......................................##.............######................................................................###
#......................................................#######..............##................................................##
##...................................................#########.#.#..........###.....................##........................##
#...................................................################.........##...................#####......#................##
##..................................................################......................#.......#####......###...............#
##..................................................#####.......#####....................###.......###........###.......#.....##
##..................................................####.........####.....................#.......###.........###......###.....#
##...................................................#............#####.###....................##..............###....####....##
##................................................................##########...................###..............#.....###......#
#........................................###......................#########.....................#...............##...####.....##
##.......................................###.......................#....###......................................######........#
#......................................######...........................###......................................######.......##
##.....................................######............................#.........##.............................####.........#
##.......................###...........#####............................###........###........##...................##.........##
###..........S..........####.#.........#####...........................###..........###.......##...............................#
###......................#.#.##........####......##...................####..........###........##.............................##
####...................................####......###.................####...........##.........##.............................##
#####.....#..........................####.........#........##.......####............##..........##............................##
#######.####.........................#####.................###......###..........................#......................##....##
#########..........................######..........................###.................................................###....##
####.########.......................#######.#..........................................................................###....##
##....#####........................###########..........................................................................#.....##
##.....######.....................############.................................................#..............................##
##.......###......................############.................................................###.#..........................##
##..............................####....####.....................................................#.####.......................##
###.............................###..................................................................#........................##
###...........................#####..........................................................................................###
####.......................#.######..........................................................................................###
###.......................##.######..........................................................................................###
###............#..........##....###..................................................###.....................................###
###............###........#......###.................................................###.....................................###
##..............###.......#......###......###......................................######....................................###
##................#.......#......###.......##...................................#.#######....................................###
##........................####.####............................................###########...................................###
##..........................#######...........................................###########....................................###
##..........................######.............................................########.......................................##
##..........................######...............................................######.......................................##
##.......##.................####.................................................#####.........................................#
##.......###................###...................................................####.........................................#
##........###.....................................................................###...........###...####.....................#
##....................................####........##..............................##...........####...#.####..................##
##..................................#######......#####............................#...........###.........###..............#####
####................................#######.......#####................................########..........................#######
####.................................######........####.#...............................######.........................#########
######..................................###...........#####............................#####.............E............####.#.###
######..................................###...........######............................####........................######...###
########.................................####..........####..............................#.........#................#####......#
##...................#..................#######.......#####.......................................###................####......#
###########.........####................#######.......###........................................####..........................#
############.........####.#............########......##..........................................###...........................#
#####...#####........######............#######.......##..........................................####..........................#
####......###........######...........######........###..........................................###...........................#
###........###.......####..............#####.........#.....................#......................###..........................#
##...................####..............####...............................###....................####..........................#
###..................###................###................................#.............##.......###..........................#
##...................####...............###..............................................###.....###...........................#
###..................###.................##...............................................###.....##...........................#
###.................#####............#.###...............................#.......................##...........................##
###.................####.............###.................................###.....................#...........................###
##..................#####............####................................###.....................#...........................###
##..................#####..............##.................................###...............................................####
#....................####.............###.................................####...............................................###
##..####..............#................##.....................##...........###...............................................###
#....####.............................#####.#.................####........####................................................##
###.#####.............................#########.#.#...........#######.....................#.#.#.#####.........................##
###..####.............................#############..........########.....................###########.........................##
######.#..............................#########.#............#######......................#####...#...........................##
####......................##....###.#.#..#.#...............#########.....................#####.............###................##
#####.....................##....####.......................########.......................####............####................##
#####.#.................#####..######....................###########..............###...#######..........#######..............##
##########......#.......####...#####...................####.########............##################......########.......##.....##
#############.########################..........#.#.#######.###########.#.#.#.####################################.#.######.####
################################################################################################################################
