################################################################################################################################
###############################################............................................................................#####
##....###################################...##....########...#############.....#######################..###########.........####
#......################..###############..........####.......############.......#####################....##########.........####
#......###############....###############.........###........############.......####################.....##########.........####
##.....##############....####################....####........###..#######......#####################....############.......#####
###.....#########.....#########....##################.......###....######......#####################....############......######
####.......####......##########.....#################......###........####....#####..################....#######..........######
####................######..###......#####..########.......###.........####...####....################.....###............######
###.................#####....##.......###....#######.......###.........####....##.....########...#####.....................#####
###.................#####.....##.......##....#######..................#####............######.....###.........#.............####
###...................##.....................########.................#####.............####.................###.............###
##.......###.................................########................#####..............###.................###...............##
##......#####.................................#######................####................#..................##................##
##......#####....................................#####................#.......................................................##
##......####......................................####................................................................#......###
##......###.......................................#####......###.....................................................###....####
##......###.............###......##.....#.........######..######...........S.........................................###....####
##.....####............#####.....###...###.........############.......................#.............................###.....####
##########.............#####.....####.####............#######........................##.............................###.....####
##########.............####........#######.............#####..........................#......................................###
##########..............###.........#####.....................................................................................##
#########...####.........###.........##.......................................................................................##
##...####..######........########..........................##...................##...........................................###
##...###...#######........#########.......................####.................####.........................................####
##....#....########........###..####......................#####...............######..................................##########
##.........########..............####................#....######..............######.................................###########
##.........########...............##...............###.....######......#.......######................................###########
##........#########................................##.......######.....###........##.................................###########
###.......#########..........................................####........#...........................................###########
######....#########.......................##.............................................##...........................##########
#######..##########......................###............................................###...........##...............#########
#######..##########.......................##.............................................##..........####....####......#########
#######...#########.....................................##.................###......................#####...######.....#########
#######...##########....................................###...............####......................#####...######.....#########
#######..############.........###.......................###..............#####.......................####....######.....#..#####
#######################......#####...............###....###..............####...............###......####....######........#####
##########################..######...............###....##................##...............#####.....####....#####.........#####
#################################.....##.........###....##................................######......##.....#####.........#####
##########....##################......###.......####.....................................######...............#####.........####
#####..###........##...########.......##........###.....................................#######................#####........####
##.....###..................##...##.............##.....................................#########...............#######.......###
#......###......................####...................................................##########.............##########.....###
#.......#.......................####....................................................###...####............####...#####..####
##.............................#####......................................#..##................###............##......##########
##...........................#######.....................................#######...............###.....................#########
##..........##.......#......########.....................................#######...............###.....................#########
##..........###.....###.....#######...........................####........#######.............####....................##########
##..........###....####......#####............................####........########...........#####....................##########
##...........#....####........####.....##......................###........########..........#######....................#########
###..............####.........####....####.................................#######....##....#######.....#####...........########
####............#####.........####...######...................................#####..####...######.....#######...........#######
######.........######..........##....######....................................##########...####.....##########..........#######
#######...###########...............######........................................#######...###.....###########.........########
#####################...............####..............##...........................#####...####.....###########........#########
############......###................##...............##............................###....#####...####..#####........##########
###########........###........#......................###..............####.................###########....###........###########
###...####........####.......###............##.....#####.....##.......#####.....###........###########.....#........#####....###
##..............######...................#####....#####.....#####....######....######......###########.............#####.....###
##..........##########.................#######....#####....################....#######.....###########.............#####.....###
##.......############.................#######......###.....##############.......######......##....###...............###.....####
##......########..................########................#############............###......................................####
##......######..................########..................############..........................................##..........####
##.......####.............############....................###...######.........................................####........#####
##........##.............#########...............................#####.........................................####........#####
##........##..........###########................................#####...........###..........................####.........#####
##........##.........###########..................................####..........#####.........................####.........#####
###..................######.####...................................##...........#####.........................####........######
####.................#####..####...............................................######........................#####......########
####..................###...####...###............#........####...............####..##......................#####......#########
####.................####....####..###...........###......######..............###....#####.................#####.......#########
###.................#####....####...#.............#......#######......##......####...######...............######.......#########
##..................#####.....##.......................#########.....######..######...#####...######......######......##########
##..................#####..............................................#############...###....#######......#####.....###########
#...................######.........................######...####......##############...........#####........####....####......##
#....................#####.........................#####.....####.......#############..........###...........###....###........#
##....................###..........................####......####........############..........##............###...###.........#
###.................................................##........###........#############........##.............###...###.........#
###...........................................................###........###..########.......###..................###..........#
###....................................................##......##........##.....######.......####..................#..........##
##.........................................##.........####......##.......##......####.........###.............................##
##........................................########...######.....##.......###.....####........................................###
##........###............................#########...#######....###.....#####....####.....................................######
##........###............................#########...########...#############.....###....................................#######
##........##.......####..................########.....#######...#############......###...................................#######
##................#######.........#.......#######.........####.#############.......####........................###...........###
##.................#######.......###.......######.........#################.......#####........................###............##
##...........##.......####.......##.........#####.........################.......######.........................#............###
##..........####.......###...................###..........###############.......######...................####................###
###........######.......#....................##...........###############.......######..................######...............###
####......#######...........................###............##############.......######.................#######...............###
#####.....######...........................#####............##############.......#####................#######................###
#####......####...........................#########.........###############.......#####..............#######.................###
####..................##.................###########........###############........######............######....####..........###
###................######................###########............############........#######.........#######...######..###....###
##................########................##..#####..............###########........########........#######...##################
##...............###########...................####...............####...###........#########.......######.....#################
##...............###########.....#..............###...............####...###........####.#####.......####........#######..######
###...###.......####..######....###.............###...............####...####........##...######..................#####....#####
##########.....####....#####...#####............###................##.....##.........##...######...........#####.######....#####
###########....###.....#####...#####............###.................................###...######..........#############.....####
###########....###......####....####.................................................#.....###..........##############........##
###.######......#.......####......###..................................................................###############........##
##...####...............####.......###..................................................................#############......#####
##....##.................##.......######..................................................................####..####......######
##.............................#########......#..........................................................................#######
##............................##########.....###...................##................##.................................########
##.............................####..........###........##.........###..............#####...............................########
###.........###...............................#........####.........###............#######...............................#######
###........#####.....................................######..........###...........########...............................######
###........####......E..............................######............###..........#########................................####
###.........#........................................#................###...........#########................................###
###..................................................................#####...........##..###.................................###
###....##............................................................#########...............................................###
#########.................###.........................................#########..............................................###
#########.......##........###...........................................########..#####........#.............................###
#######........####.............###..................##.................#################.....###.............................##
######.........#####............###...................#.................##################.....#..............................##
####..........######.............#..........####....................##############..######....................................##
###..........########......................######.............###..#######..#####....####........................#............##
###.........###########....................######.......##...############....####.................#.............###...........##
###.........############..................#######.....############............####................##............###...........##
####........############..............##########.....############...............#.................#..............##...........##
#####......#############.............##########.....#############.........................................#####...##..........##
######....#############..............##########....##############.........................###............#######.####.........##
######...##############.....###.....###########..##################.....########....##########..........#################....###
#######.################..######..###############################################################...############################
################################################################################################################################
