################################################################################################################################
##########..################...########################################......#######################...###############.....#####
###............#####..#####.....########....#####################..###...........###########.................########........###
##..............##...............######......###################..................#########...................................##
##...............................#####.......#######...#####............#..........########...................................##
##..............................#####........######.....####...........###..........#######...................................##
##.............................#####.........####........####.........####...........#######..................................##
##.................##.........###.............#...........##.........#####............######..................................##
#.................####........##........##..........###.............######.............######.................................##
#.................####.................####........#####............######..............##########.............................#
#..................##..................####.......#######...........#####................##########............................#
##.................##...................##........#########.........#####.................#########............................#
###................###...##........................##..#####........####......................####.............................#
####...............###########..........................#####.......####.......................##..............................#
####...............############...........##.............####........##......#................###..............................#
####...............############..........#####...........####...............###...............###.............................##
###................######.#####...........#####...........##.................#................####...........................###
##.................####....####...##.......####................................................###...........................###
##................####.....####...###.......##..................................................##...........................###
##..............#####.....#####..######.......................................................................................##
##............#######....#####...#######.................................##...###........###...................................#
##...........########....###.....########...............................##########.......####..................................#
##...........#########...##......#########.............................############.......##..................................##
##..........##########............#######..............................##############.......................................####
##.........##########..............###.........................##......###############.....................................#####
##.........####..###..........##..............................####......##############.....................................#####
##........####...............####.............................####......##############.....................................#####
##.....######................####..............................##......###############..................................########
##....###...................##........................................###############..................................#########
##....##..............................................................#############.....................................########
##.....................................................................#.......###......................................########
##.................#......................................##.............................................................#######
##................###....................................####........................##.....#......#........................####
###..............#####....................................##........................####..####....###........................###
###..............######.....................####...................................###########...####.........................##
###..............######....................######.................................############...####....##...................##
##...............#####...................########............................#######..########....####..####..................##
##................####.................##########..................###......#######.......####.....#########..........##......##
###..................................######..####.................#####.....##.####........####....##########........####.....##
#####...............................######....##..................#####.........###........####...###########........####.....##
######...............................#####.........................###..........####........##.....#..#######.........##......##
######................................####...........####.......................####...................#####..................##
######..................###...........###............#####.......................##.....................###...................##
######..................###......#...###..............######............................................##..........##.........#
######..................##......#######..........##....######..................##.......................##.........###.........#
#####...................##.....#######....................######..............####......................###.......###..........#
###......................##...####.##......................#####..............####.....................####......####.........##
##.......................#########.##......................#####...............###....................#####......###....##....##
##.......................#########.##.......................##.......................................#####.............#########
##.......................#########.#................................................................####...............#########
##......................##########.....................................................##............##................#########
##.....................###########....................................................####.............................#########
##.....................###########.............................##......................#####..........................####...###
##......................##########.............................###.......................####.........................###....###
##............................####......##.....................####.......................###..........................##...####
##.............................###......##......................####...................................................##...####
##...###.......................###......##.......................###..................................................###...####
##..#####....................#####.................................................###............................#######....###
#...#####..................#######................................................#####..........................########....###
#....###...................#######.##.............................................#####..........................#######....####
##..........................######.###........#..................#.................####...........................#####....#####
###..........................#####.###........##................##............##....####.........................#####....######
###............................###.###.........#.................#...........####...####........................######...#######
####.............................####.......................................######.#####........................#####....#######
#####.......................................................................############...............###........##......######
######.................................................#####.................##########................###.................#####
######..........................##.....................########...............########..........#......###.................#####
#####..........................####........................#####................................##.....###................######
##.............................#####........................####................................#......###....##..........######
#.............................######........................####.......................................###...####.........######
#..............S..............##............................####................#......................###..######...........###
#.............................#.............................####................#........##............###..######............##
##...........................................................##.................#.......####...........#....#####..............#
###..........##...............##...............#................................#........####........###.....###...............#
###..........##...............##..............###.............................###.........####.......#........................##
###...........#...............#...............###..............................#...........###.......#........................##
####..........................................###...........................................#.........................####....##
####................................##........###.............##.....................................................######...##
###.................................##.........##......###...###.....................................................######...##
##..................................##.........###....##########.........................................###..........####....##
#.............................................####....###########..................................#########...........##.....##
#.............................................####.....###..######................................#########....................#
##.............................#####.........####............######...............................########.....................#
###...........................#######.........##..............########.............................#####E.....................##
####..........................###########......................#######....#............##...........###......................###
####...........................###########.....................#######...###..........####..........###....................#####
###...............##............##########.....................#######....##..........####..........###...........#.......######
##...............######.........###########....................########...###.........###........................###......######
##...............#######........#####..####....................########...###........####........................###.......#####
##..............#######..........###....###....................#######.....###..##..#####.....###...............####.......#####
##.............########.................###.........###........#####.......##############....####.............######.......#####
##............#########.................####.......####....##...##.........#############....#####............######.........####
##...........###########................#####......#####.#####..............#######........####...............####..........####
##...........###########...............######......############................###........####..............................####
##...........###########.....##.......########......############................##........####..............................####
##............#########......###.....#########.........#########..........................#####..............................###
##.............#######........#####...########..........####..##...........................#####.............................###
##..............#####..........####....######...........###.................................####............................####
##................##............##.......###...........####.................................#####...........................####
##..............................................###########...................#.............#####...........................####
###.................................##..........###########..................###...........#####.............................###
####...............................#####........##########....##..............#............#####..........................#.####
#####..............................######.........#######....####...........................###..........................#######
####................................#####..........#####.....####........................................................#######
###.................................####....................#####.........................................................######
##...................................##.....................####...................#######..................#.............######
#...........................................#..............#####..................#########................###...........#######
#..........................................###.............####....................########.............................###...##
#.......###................................####.............##......................#######.............................#.....##
#.......####..................#####.........##.......................................#####....................................##
#.......####.................#######....................##...........................####.....................................##
##......#####.................#..###....................###...........................#...................##.................###
###....#######....................##....................####............................................#####...............####
####...########.........................................####.....########.............................#######...............####
#####..########..........................#####..........####....##########.......###.................#######............#....###
#####...#######.........................######...........##.....##########.......####.......##......#####..............##.....##
####....#######..........................###.....................########........####......####.....####................#.....##
###.....######........................................................##..................####.......##........................#
###.....####..............................................................................###..................................#
##......###................................................................................#...................................#
##................................##...........................................................................................#
##..............................#####..###................###..................................................................#
##.............................###########...............####.........##..............................................##......##
##............................###########................####........####.......................................##...###########
##...........................############...............####.......#######.............###.........##..........#################
########.......####........###############..###...##########......#########....###...######.......####.........#################
#####################..######################################.##############################..#########.......##################
################################################################################################################################
