################################################################################################################################
#####################################################........................................................................###
####.#.#######...############..########.#############....###########...########......#######....................###...........##
##.......####.....##########....######....#########......#########.......####........#######....................##.............#
##.......####.....##########...#######...####...###........######......................####...................................##
##.........##......########....#######....####............#####........................######..................................#
##.........#......###########.#########....#.......#......###...........................#####.......#.###.....................##
##...............############..########............###...####...........................######.....######.....................##
##...............#############.#######............###########............................#####....#######.....................##
#..............#########..###....#####.............###########...........................#####....#######........##..........###
#.............#########..........####..............##########............##...............#####.####.#.#.........##..........###
#..............#######.....##.....###......S........#########............##.............##########.....#.........###..........##
#................####.......#........................########.............##............########.........#.......###.........###
#..........................###.......................########.........................########...........##......###..........##
#...........#...............##........................#######.......................########.............##......###.........###
#...........##.............###.......................########.......................#######..............##......###..........##
#...........##.............###........................######.........................####........................###.........###
#........................####..........................#.####.........................#.........................####..........##
#.......................######..................................................................##.#............####.........###
##......................#####..............................##.................................#######............###.........###
##....##.................#####.............................###....................#.........##########...........###..........##
####.###..................####...........................#####...................###.......########.#.............####........##
####.#............#.#..#.######.........................######...................###......#######................#####.........#
####............###############........................###.#.....................##......#########...........#...######........#
###.............################.....###.........................................##....###########...........##.#######........#
####...........##################..######........................................#.....####...#####..........##.#####..........#
#####...........########################...............................................####.....##..............#####.........##
#######........######################...................................................#........................####..........#
#######........####################.....................................................#.#......................####.........##
#########.....######################....................................................###........................#...........#
#########.#.#.#.###########.#######....................................................#####..................................##
#############....##########...######.........................###......................#######.............#..#.................#
###########........#######....######.........................##..........#.##.......########............#######...............##
#########...........######....#######.......#.........###.....##.........######...##########..........#########.##...........###
#######..............#####....######.......###.........###..............########....########.........##########.###......###.###
#####................#####....######........###.......####..............########.....######..........##########.####.#.#####.###
###..................#####....#####..........#.........####............#########......######..........####.#.##.############.###
#...................######...######....................#####............########........####...........###......############.###
##...........###...#######....#####.....................####...........#########................................######.......###
#............#############.....####.......................####.....#....########................................######.......###
##............#############.....####.......................###.#.####...########................................#####.........##
##..............######..###......###........................#########.....######.#.......................#.......####........###
##.............#####.....###......##..........................#####...........##.##.....................####.......#.........###
##.............######....###..............#######...............###..............##........#.####........#####.....#.......#.###
##...........#######......##............##########.......................##......####.....########.......#####.......#...###.###
##...........########....###............#########.......................####.....####.....########.......####.......########.###
##.........#########.....###............##########.............#.#......#####.##.######...########.......####......#########.###
##........###########....###............##########.#.........#######.....#######.######....#######.......###........########.###
###........##########.....###...........####...########.#.##########.........###.######.....#######.....###..............###.###
##..........#########......#.#..........#####...##.#.################........###.####........######....###................##.###
###...........#.#####........#..........####.........################.........##.#####........#####...###.......#..........#.###
####............#####........#.#........#####..........###....#######.........##.#####.........####...###.......#............###
#####.............###.........#####......###..................########........##.#######........##...####.......##...........###
#########........####........#######.....#####................#######........###.#########......####.#####...................###
#########.........###.........#######......#####...............########....#####.###########....##########.................#.###
####.............####.........########........##................################.###########....##########.................#.###
##...............####...........#.#####................###........##############.###########....#########..................#.###
##..............######............######...............####........#######...###.##########......########....................###
#................####..............######..............####........######......#.#########.......#######.....................###
##..............#####...............######...............##........#####.........#.#####.........########....................###
#...............####..................#####........................####..............#...........########....................###
##.............####.....................###.......#...............#####...........................########....................##
#...............#.......................###......##................###............................########...................###
##......#.#..............................##......##.................#...............................######....................##
##......#####..........................................................................................##....................###
##.....#######..................................................................................................##...........###
##......#####.............................................................#...................................#.#............###
#.......######..........................................................####..........##......................#.##...........###
##........####.......................................................########.........##....................###.#............###
#..........###......................................................##########..............................###.###.#........###
##..........###....................................................#############...........................####.######........##
##.........####....................................................####.#.######.#.........................####....#.#........##
####.......###.....................................................##.......####.#.........................###.................#
######.....................................................................#####.#.........................###................##
########...............................................##.#.#.#.............####..............#............###...........#....##
#########.............................................########..............####............####...........###..........####.###
#########............................................##########.............####.##.........#####..........###..........####.###
###....#..............................................########...............###.###........###............####........#####.###
##.....#.#.....................................#......########...............###.##..........##...###.......##..........####...#
##.......#.....................................##.......######................##.##.................###.....###........###.....#
##......####...................................##.......######................##.#.................#####....###.#......###.....#
##.......##..............................................#####.................#.#..................####.....##.##.....###.....#
##........##.............................................#####.................#.#.....##..........######....##.###....####....#
##.......................................................######................#.##..#####..........#####....##.##.....#####..##
##.......................................................#####................##.########............######..##.###.....########
##......................................................######.............#####.########............######.###.##.......#######
##......................................................#####............#######.#######...............########.#...........####
##.....................................................#####............########...#####...............########.#.............##
##.....................................................#####............########.....###.#.#.##.........#######...............##
##.....................................................#####...........#########.....##########........########................#
###....................................................######...........########.#...##########.........######.................#
###.#.#................................................######...........##..####.#....########..........######.................#
########...............................................####..................###.#......######...........#####.................#
#########.............................................###.....................##.#.......................####..................#
########.............................................###...........................................###...#####....###..........#
########............................................####...........................................##....####.....####.........#
######.............................................#####.................................................#####..#####..........#
######....##.......................................#####.................................................####...#####.........##
#####....####......................................######................................................####...####..........##
####.....####.......................................#####......................#.##......................##.....####.........###
###......####.......................................######...................###.####...................###.....###..........###
##.......###.........................................####....................###.######...............#####..................###
##........###.........................................####.............#.#.#####.#########...........######...................##
##.......###............................................##...........###########.##########...........#####...................##
##........##...........................................####..........###########.############.........####....................##
###.....................................................###...........#########....###.#.####..........####.........E.........##
###....................................................#####..........##########...#.....######.........##....................##
####...................................................#####...........#########.#........#####.........####.................###
####....................................................#####..........############.......#######........###.................###
#####...................................................####.....##......###########......########.......#####.............#####
####......................................................#.......##......##########......#########.......#####............#####
####.............................................................###......##########.....###########.....######.#.#.#.##########
####..............................................................###...##....................######......#####.################
####..................................................................####....................######......#####.################
####.................................................................#####....................######......#####.#.#.############
####..................................................................####....................######.......####......###########
####..................................................................####....................######.......###........##########
####...................................................................###....................#####.........###.......##########
##....................................................................####....................#####.........###......###########
##.....................................................................###....................####..........#####....###########
#.................................................##.................#####....................#####.........#####..#############
#.................................................##.................#####....................####...........###################
##...#######.......................................###.............#######....................#####..........###################
###########..............................##.......####.............#################.........#######..........##################
############...........................#####......######.........###################.......#.#########........##################
############.......#############.#######################.........##################......###############......##################
##############.#.#########################################.#.#.######################.###################.#.####################
################################################################################################################################
