################################################################################################################################
##########.............................................................................................................#########
#########..........############....######.......###...........####...###......#################..............#########.#########
###.................##########......#####......................##.............##########......................########.#########
##...........##.....##########................................................#########........................####..#.#########
##..........####....##########................................................########.................................#########
###........#####....##########..................................................##.....................................#########
####.......####.....###########.........................................................................................########
#####................###########.............................######.....................................................########
#####................###########............................########...........#####...................###..............########
#####...............############..........#..................#######..###....########...............######.............#########
####....##.........############..........###..................#####..#################.............#######.............#########
###....####........#########............#####........................##########..#####.............######..............#########
##.....####........########......#......#####........................#########....#####.............##...............#.#########
#.......##..........#######......##.....######........................####........######......................##....##.#########
#...........###........####......#......######.........................##.........########...................####..###.#########
#..........#####........##..............#####...............####..................#########..................####..###....######
##.........#####.........................###...............######................##########...................##...###....######
##.........#####...............#...........................#######................###...##.........................###....######
###.........####..........#######..............................#####...............................................###....######
###..........##..........########..........##....................####.................................##..................######
###.....................########..........####....................###.................##.............###..................######
###....................########..........#####....................###................#######...#######.....................#..##
####..................#######............#####....................###............###..#################........................#
#####...............#######...............###.............##.....#####..........#####.......##########....##...................#
#####..............######................................####...######..........#####..........#######....###..................#
#####..............#####...............###..............#############...........#####...........#####.....####.................#
####................##................#####..........###############............#####...........#####.....#####................#
###....##.............................#####.........##############.............#######...........###.......####................#
###....##.............................#####..........###########...........############........................................#
####...###.............................###..................###.......##..#############........................................#
###########.............................#.......#...........##......#####.############........................................##
###########....................................###.........##......#####...##########............###.........................###
###########...................................####................#####....##########............###........................####
##.....####............##.....................####...............#####......#########..................................##..#####
##......###...........#####....###.....#......####...............#####............###................................#.#########
##......####..........############...####......###................#####.............................................##.#########
###......#####.........##########....#####......#....................####..####..............##....................###.#########
####......#####.........#########....######.........................###########..............###...................###.#########
####.......###...........########...########.........................##########........#.....###..................####.....#####
###......................#########..#########.###..........##.........########........###....###...............#####.........###
###......................#########..########..##...........##.........######..........###....####.............#####..........###
###......................########....#####..................##.........####............##....####.............#####..........###
##.......S................#######.....###...................##..........##.............###..#####..............#####........####
##..........................######.................................................#############.................####.....######
##....................##.....######..............................................##############...................##############
##...................####.......###..................................##....###################..............#.......############
##...................####...........................................######################.................####......######...##
##...................###.........................................################...#####...................######...####.....##
###...........####...............................................###########.........####............##......######...##......##
####..........####...................................##..........###########.........###........#######......######...........##
####..........####.............................#....####...........#########........####.......########......#######..........##
###...................................###.....###...#####...........#########.......###........########......#########........##
##...............................##...####....###...#######...###....########........##........########.....###########.......##
#................................##...####.....#.....############.....########........##.......#######.....############.......##
#................................##...####............##########.......#######........###......#####.......###########.......###
#.......##.......................###..####............######............#######........###..................#########.....######
##......#########.................##...###............#####..............#########.....###............###.........##.....#######
##.......#########................###...###..........######..............##########.....##...........#####..............########
##........#########................##...###..........######...............#########.....##....####...######.............########
###.......#########.....................####.........######.........##.....#######.....####..######..#######.............#######
####.......#########...##...............####.........####..........####....######.....#############...#######...............####
####........##############..............#####........###...........#####...#####.....##############...#######................###
####.........#############...............#####.......###..........#######...###......##############....######................###
###............##########.................####.......####........#########..........######...#####.....#####.................###
##...##..........#####......................##........#####......##########..........##.......####....######.................###
##...######........##........###.......................#####.....##########....................##....#######.................###
##...#######................####.......................#####.....###########........................############............####
###...######.............#######........................#####....############.......................############............####
####...####..............########.........................####..#############......................######...###.............####
####....###..............########..........................################.......................######....................####
####....###..............########..........................##############.........................######.....................###
###....####..............########.........................##############..........................######.....................###
###...######...###.......########.........................##############..........................######.....................###
###################.......########........................###############.........................######.....................###
###################.......########..............##........#######......###..................###...#######........##..........###
###################......########............######........#####........##..................###....#####........########.....###
#####..############......######.............########.......####.........##......................................########.....###
##.......##..#######.....#####..............########.......####.........##......................................#######......###
#...............####......##........##......#######........#####........###.....................................#######.....####
#................####..............####.....######..........#######....#####......................................#####.....####
#.................#######..........#####....#####............#######...######...#...................................###......###
#.................########..........#####....####.............######...###########...........................................###
##.................#######...........####.....###......####......###....#########......E.....................................###
##..................######............##.......##.....#####.......#......#######......................###...................####
##..................#####.............................####................#####.........##.....###...####...................####
##..................####...............................##..................###........#####...###########..................#####
###.................####....................................#...#....................######...###########..............#########
###................#####...................................#######...................######....##########.............##########
###................#####......#####.........................#####...................######......##...###.............###########
##................######......######...............................................###........................#......###########
##................#####.......######.........####.................................###........................###....############
#..................####.........#####.......######.....###........................###........................####..#######...###
#...................##...........####.......######.....###........................####........................############....##
####..............................###.......#####.......#..........................###.........................###########....##
#####.............................###......######..................................###............................#########...##
######.............................###.....######..................................####...........###..............########...##
########..........##................#.......######..........................###....#######.......####...............##..####..##
#############....####.........................#####.....................#######.....#######.....######...................###..##
##############...#####.........................#####....................#######.........##......#######........................#
###..#########....######.......................#####....................######..................########...........#...........#
##....#######......#####........................####....................####.....................##..####.........###..###.....#
##.......####.......###.........................####...................####...........................##..........#########...##
##........###.......##...........................##.....#.............####.................###.....................#############
###........#.......####................................###......##....###..................###.....................#############
#####.............###########.........##...............####....###........................####....................##############
######............############......#####...............###....###......................#####.....................##############
######.............##..######..................................###.....................#####......................##############
#####.....##............################.......................###.....................#####......................##############
#####....######..........############..........................###......................#####......................#############
#####....#######.........####..#####.........................................##..........####.......................############
#####.....######.........###....##...........................................#######......##.........................###########
##........#####..........##.............................#.....................#######.................................##....####
#........#####..........................................##...........###.......#######..............##......##...............###
#.......#####................###........................#...........#######.....########........#######..######..............###
#.......#####...............####...................................#########....#########......######################........###
##..##..######..............####............................##....###########...####..###......#####.#################........##
##..#....#####.............####............................####..###########.....##....##......####...###....#########........##
#..........##...........#####.............................#####..########..............##.......##.............########.......##
#.......................####.......##.....................#####...######..............###.......................#########.....##
##................................###.............###.....#####....#####..............####.......................#########....##
###.......##.....................#####............####.....#####...#####...............###...##.........##............#####..###
#####....####...................#########.........#####.....############...............####.####.......####............####..###
######..#####...............##############........#####......###########........###....##########.....#####.............##....##
##############............################........#####.......##########........###....##########...#######....###............##
##################......###################.......#####.......###########......#####..#####################....####..........###
############################################.....#######.....###############################################..###########...####
################################################################################################################################
