################################################################################################################################
###################...........................................................##################################################
##################.........####################...........####..#.###..........###################..####..#################..###
##################..........##########....####..................#.#.............#################..........#######...#####....##
##############...##.........#########.....####..................#................#################.........######.....###.....##
#############....###...##...##########.....####..............####.......##...........##############.......#######..............#
############....#######################......#...............####......####...........#############......########..............#
#########.......########################.....................###......####.............##...#######.....#####..##..............#
########.........########################............###..............###....................#####......#####..................#
########..........########################..........#####.............##......#####...##......###.......####...................#
#######............#############...#######.........#######............#......###########......###..............................#
######.............#######..##.......######.......S########...................#########........#..............................##
#####.............######.............#######.......############................##.........................###.................##
####.............######............#########........############.........................................#####...............###
###..............######...........#########...........###########....###.................................#####...............###
###..............######..........#########.............##########....###..................................####...............###
###..............######.........#########..................######....###...................................##.................##
####......###...######..........#########...................####....#####.........................##..........................##
######....###....##............##########..........................######........................####.........................##
#######..###...................###########.........##.............######..................##.....#####........................##
###########....................###########.......#####.............##....................####...######........................##
###.#######............#####....#########.......#######.................................##############.......................###
##....######..........#######.........##.......########....##..........................###############.....................#####
##.....#####..........########..............###########....#####......................##########...###..............##....######
##......####....#......#######..............###########....######.....................######........###............#############
##.......###...###.....######...............##########.......####.#....................####..........##...........##############
###......###...........#####...................#######........###.##...................###......................################
####....####............###.....................#####.........###.###......##..........##......................#################
#####...####...............................##...###...........###.#####...####..##.............................########....#####
#####...####.........#....................####................###.#####....########............................########......###
######...##.........###...................####................###.#####....########.............................######........##
#######.............###...................###..................##.##.......#######..............................######.........#
########............###.....##............###..............................######................................#####.........#
#########...........##....#####...........##.............###................####...................................###........##
########.......##..##.....#####................###......####...........###............................###...........###......###
#######.......######.......####................#############......#...#####...........................#####..........#......####
######........######........###................########...........#########.............................####...............#####
######........######.................##........######.............#########..............................###..............######
######.........###########..........####.......#####..............########...............................###..............######
#######.........##########..........#####.....######..............#########.##...##......................##...................##
########........#########............#####....######................################....................###...................##
########........########..............####.....######......##.........##############...................###....................##
#######..........##....................####.....#####.....####.........#############..................####....................##
###........###.........................####......####....####...........############.................#####....................##
##.........####........................####.......##.....##.............###########..................######...........##......##
##........#####.........................##........................##....##########....................######........####.......#
##......#######...................................................##...##########.........###...........####......######.......#
##.....#########....................###...........................##...##########.......######...........##.......######.......#
##....####..####...................#####..........................##....########......#########...................######......##
###..####....##.....#.......###....#####.................................######......#########......................####.....###
#########..........###.....#####....####..................................##.........########........................####..#####
########...........##.....######.....###.............................................#######.........................###########
#######...................#####.......###..##.....................#.................########................##.......###########
####......................#####.......########....................##...............#########...............###.....#############
###.......................#####.......########....................##...............#########..............####....##############
###......................######......########.....................#................########..............####.....##############
###......................####################...........##..........................######...............####......#####....####
###.....................################..####.........###............................####................##.......####......###
###.....................###############....####........#................##.............###........................######.....###
###......................#####....######...####........#..........##...####............###........................#######....###
###.......................###......#####....##....................###..####.......#..............................###...##...####
##..................................#####.......................#.###...##.......###.............................###........####
##..................................#####....##.................#.###............####.............................#........#####
##..................................######..####................#.###............####.................##..................######
###................................#############................#.##..............##.................####.................######
##########........................#############.................#.##..................................###.................######
##########.......................#############....................#....................................##......##.........######
#########.........................##########...........................................................##.....####........######
###...................................................##........................###...................###.....####.......#######
##...................................................####...##.................#####.................####......##........#######
##...................................................####...##.......##........######................#####................######
##....................................................##....##......###........###########...........#######.................###
##.........................................................####....####........############..........##########...............##
##.................#####...........###....................#####...#####.........###########..........###########..............##
###................######..........###....................#####...#####.........##########..........###########...............##
####...............######...........##......##.............####...#####.........#########..........###########................##
#####.................###..................####..............##....####.........#########...........#########.................##
####...................##...##..............####..............#.....##..........##########....##........#####.................##
###........................####..............###..............##.................##########..###..........####................##
##........##...............####..............###.............###..................###############..........###................##
##.......###................##...........................######....................###############..........###...............##
##.....#####...###......................................######..........................###########..........###.............###
##....#####....###.................................##########............................###############......###............###
###..#####........................................#########.............###...............##############......###.....###....###
#########.....................................############.............#####.......##.....##############......####..####....####
########.....................................#############.........#..#######.....####....##############.....###########....####
########.....................##.............#############.........###########.....#####..#######....#####.#############.....####
########.....##..............##............############............##..######......############......##################......###
#######.....####..........................############..................##..........###########......#######..#########.......##
#######....#####...........................#...######...............................############.....####......#######........##
#######.....#####...............................####.................................#####......................######.......###
#######........######............................###....................##...###......#############..............######....#####
#######.........#####................##...........##..................###########.......###########...............##############
#######.........#####..........##....###...........#...............##############.........########.................#############
#######.........######........###....###..........................##############..........####......................############
######..........########.....####.....#...........................###########.............###........##..............##....#####
#####...........#########....####.................................##########..............####......####......................##
####.............########.....####......................##......#.##########.............######..#######.......................#
####...............#######....######...................####.....#.##########.............###############.................##....#
####...............########..########.................#####.....#.#########....##.........###############...............####..##
####...............###################................#####.......########....#####.........######...####...............####.###
###...............############..#######................#####......#######.....#####..........####.....##.................##..###
##..............#######..####....######.................######.....#####......#####...........###........................##..###
##..............###..............#####...................######....####........................#........................########
###.....................................................########..###..................................#............############
######.................................................##########.##..................................####..####....############
######.................................................##########.##...................................##########....###########
###..................#..................................####..###.##......................####............#######......#########
##..................###.........##.......................##....##.#......................######.............####........########
##.....##...........####..##...####.............................#.#......................######.....##..................####..##
###...###...........#########..####.............................#.#.......................####.....######...............###....#
###...###...........#########..###..............................#.##..................##...........###...................#.....#
###...##...........##########...#.........................##...##.###........#.......####..........#######.....####...........##
####.............############.......E....................########.######....###.....#####...........######.....#####.........###
####............#############.......................#############.#######....##.....#####...........#####.......####........####
####............#############......................##############..#######...###....#####...........####.........###.......#####
###..............###########......................##############....#######...##...######............###..........##......######
###..............######..##........................#############....#######........#####............#####.........###.....######
###.........##..####..................................####...###....######.........####...........#######.........####....######
###.........#######....................................##....###...######..........####...........#######....###...####....#####
####.........######............................##...........###....#####............##............######.....####..####.....####
#####........######...........................####.........####.....####..........................######.....####..###.......###
######.......######......########..............###........######.....####................##........####.......##..............##
#######.......#####.....##########.............####......#########....####.............#####........#.........................##
########......######....##########............#####################...#####...........######.............###.................###
########.....########..############.........######################################...#######............##########..........####
#########...#################################################################################....###..##############..###..#####
################################################################################################################################
