################################################################################################################################
######......................................................................................................................####
######.##......#########.......###########..######.....####################.....########.....####...........####.........##.####
######.#........#######........#########.....####..........########...####.......######......................##...........#.####
######..............###.......##########....####...............##.....####.......######.................#...................####
####................####......##########....###.......................####........######...............###.....#............####
###..................#####.....#########....###......................#.###.........######.........##..###.....###...........####
###...........##.....######.....####........####..................####.##.....##.....#####.......########....####....###....####
###..........####.......##......###.........#####.................####.#.....####.....######....########....#####....###....####
###.........#####...............###.........#######................###.#.....#####......#####....######....######....###....####
##.........######..............####..........#######................##.#......#####......####.......###....#####............####
#.........######...............####...........#######...............##.##......####.......##.........##.....####.............###
##.........#####...............#####...........#######...............#.#####..####...................###....###....####......###
###.........#####...............#####...........########...##...........##########...................###..........######.....###
#####........########..........########..............#########..............#######......##..........##...........#####......###
#####........#########..################..............########...............###############........###............##.........##
#####.......############################..............#######.................################.....####.......................##
####........###################..#######...............#####.........####........##############...######.....................###
###........#############..####.....######...............####........#########.....############...########....................###
###....######....#######...##..........###..............####.........#########.....#######.......########..........###.......###
####...####........#####................###.............#####........##########.....####........########..........####.......###
####...###..........####................###...........########......############.....##.........#####.............####......####
####................###................####..........#########.....#############.................##...............####......####
####................###...............#####.........###########...##############................................#.####.......###
###.................####....###......#####........#############...##############.............................####.####.......###
##.....###..........####....###......####.........############.....#############............................#####.####......####
###..#.###...........##....###.......####.........############.....#############..................######.....####.###.....#.####
######.###................###.......######...........#########.....#####.######..................########.....###.#......##.####
######.#..................###.......#######...........#########.....###..#####...................#########.....##........##.####
######...................###.......#########..............######.........#####....................#########....##........##.####
######..........S......#####......#############............########.......#####.......###..........########....##.#......##.####
######................######......##############............########.......#####.....#####.........#########..###.#......##.####
######................#######......#############................####.......######....#####..........###.#########.##.....##.####
######...........###...##..###...............##..................###.......######....#####...............########.###....##.####
######.#........#####.......#...............................................####.....####.................#####...###....##..###
######.##.......######.............................#................................#####...................##....####...##...##
######.###.......######...........................###..............................######.........................######.#....##
######.####.......######...........................#..............................########........................######......##
######..####.........###.................##..##..................................##########..............##.......####........##
#####....###..........###...............#######.........#.....................######...#####............#######...###.........##
####......#...........###...............#######........###...................#####......###............##########.###.........##
###...................###................#####..........#...................####.......................##########.###.........##
##....................##...................##...............................###............................######.###........###
##......###..........###.....................................................#.............................######.##.........###
#.......###.........#####.###...........................................................####....##.........######.#...........##
#........#.........#########..........................................................#############........######.............##
#.............###########...........................................................###############.........#####.............##
##...........###########....................................##....................#######....#####...........###..............##
###...........#########....................................#####.................#######.....................###..............##
####................###....................................######......#.........#######.....................##..........##...##
####.................###....###............................#######....###........#######.................................##...##
####.................###....###...................##........#######..###............####.................................#...###
###......##..........####...###.................#####........##########..............##......................................###
###....####..........####....#..................#####..###....#######........................................................###
###....####...........###.......................#####..####...#####..........................................................###
###....###.............#....##..........###......###...####...####...............##.........................................####
###....###..................####........####...........####....##...............####....................##..................####
##......###.................#####.......#######........####....................#####....................##..................####
#........##...##..............####.......########......####...................#####.........................................####
#............###...............###........########....#####.......###........#######.###....................................####
##..........###......##.........#..........##..############.....######.......###########....................................####
##..........##......####........................###########...########........#########......................................###
##...................####.......................######...##...###.####..........######...........###.........................###
##......................##.....................######.....##..##...####...#.......####..........######.......##.....####......##
##.......................##...................######......##...#...####..###.......##...........#######.....###....#####.#....##
##.......................###..###.............#####......###...##...##...####..................########......##...######.##..###
##........................########.....................#####...##........####..................########...........######.##.####
###....######..............########..................#######..............####................#####...............######.##.####
######.#######................########...............########.............####.............########.............#.######.##.####
######.#######................#########....#.........###...####............###.............#########...........##.######.##.####
######.######.................#########...###...............####............##..............#######...........###.######.##.####
######...####................#########....###................####....#......###.............##................###.######.##..###
######...####...............#####........####.........##......###...###.....#####..........##................####.....##.#....##
######...####...............####.......######........####.....##....####...######.........###...........########.......#.#.....#
######...####................##......########........####....###.....############........####.........##########.........#.....#
#####....####.........####........##########.........####...###.......##########.........####.........###########........#.....#
####.....####.........#####.....###########...........##...####........########...........##..........###########........##....#
####.....####.........######...###########.................####..........######...........................########.......###..##
#####....###.............####.#####..####...................###.............##............................########........######
######..####..............########....###....................#.....................#......................########........######
############...............#######....####...#.......##...........................###.................#..#########.......#######
###########.................#####.....#########.....####.........................#####...............######...####........######
##########...................###......########......#####........................######..............#####.....##...........####
######.................................######........#######......................######.............####....................###
#####...........###....................#####.........########.......................#####.....###...#####............###......##
####.....##.....###....................####..........#######.........................#####...############............###......##
####....####....####..................####...........######..........................#####...#############............##......##
###.....####....####...............######............######..........................#####....#############...........##......##
##.......##......##...............#######.............######..##......................####.......###########.........###......##
##..........................##...########...####.........########....................#####............########........##......##
##.........................###############..#####..........######.................########.............########...............##
##.........................###############...#####............####...............#########..............#######...............##
##..........................###############..######...........####...............##########..............######...............##
##.............................############..######...........####...............###########.............#####................##
#....................###........##########....#####...........####...............###########............####..................##
#...................#####.......#########.......##.............##................#######..............#####...................##
##..................#####........#####...................................#####....#####..............######...................##
###.................#####...................................####........#######....#####.............######...................##
###..........#......####................................#########.......######.....#######...........#####...................###
###.........##.....####...........................##...##########.......####.......########...........####...................###
##...........#.....####..........................#################.......##.........#######............###....................##
#...................##...........................#########....####.##................#####.............####...................##
#...............................................#########........#.####...............................########.................#
#....##.........................................#########..........#####..............................##########...............#
#....###.......................#.........###....#########...........###.....................#####.....###########.............##
##...##...........##..........###........####....#######...........................##############.....###########.............##
##.........##....####.........###.........####....#####..........................################.....###########....##.......##
##.........###..#####.........####........####..................................################......##########.....##.......##
###........#########..........#####.......####.................##...............########..######......####...........##........#
###........#########..........#####.......####................####.............########....#####.....#####.....................#
###........##########.........#####........##.................####.............########......##......#####.....................#
###.........###########........####...........................###...............#######...............#####...##...............#
####...........#########........####.........................####...................###..................########........#.....#
######.........#########.........#####.......................#####.........................###............#######......#.##....#
######........##########.........#########...................######.......................#####............######......#.###..##
######.......###########..........########..........##.......######.....##................#####....###.....#####......##.#######
###.........######.#####............######..........#...........####...####...............####....####......#####..#####.#######
##..........#####...####.........................................###########..###.........####....##.........###########.#######
##...........###...######.........................................#####..#########.........###...............###########.#######
###................######.................................................#########.........#..............######..#####.#######
######.............######..................................................########.......................######....####.#######
#######...........######...........#####..##.................................######...................E...######....####....####
#######..........######...........###########.................................#####.......................######...###.......###
######...........#####...........#############................................######.......................####...###.......####
######...###.....#####...........################..................###.........#######...........................####....#######
############.....######.........##################................####.........#########........................######..########
#############...############...####################....##...###########.......#####################....###.....#################
################################################################################################################################
