################################################################################################################################
#########.....##############..............#########.#.#.#####.#.#######.######.#.#.........#.#.#......########.#.#.#........####
###...........###########.......................#.....S...........####....##............................###.................####
##.............####...........................................................................................................##
#...............#.............................................................................................................##
#.............................................................................................................................##
#..............................................................................................................................#
#.............................................................................................................................##
#............................................................................................#................................##
#...........................................................................................###..............................###
#...........................................................................................#####............................###
#...........................................................................................#####.............................##
#.............................................................................................####............................##
#...............................................................................................#..............................#
#..............................................................................................................................#
#..............................................................................................................................#
##......................#......................................................................................................#
#.......................##.....................................................................................................#
##.......###...................................................................................................................#
#......######..................................................................................................................#
#.....########................................................................................................................##
#.....########.................................................................................................................#
#....##########...............................................................................................................##
##...##########................................................................................................................#
##...##########...............................................................................................................##
###....#######.................................................................................................................#
##......######.................................................................................................................#
##.......###......................................................................................................#.#.####.....#
#.........##.................................................................................................#..##########.....#
##.......................................................................................................#...##.#.#.######.....#
##......................................................................................................##............#.#.#....#
###............................................................................................................................#
####...........................................................................................................................#
#####.........................................................................................................................##
#####........................................................................##................................................#
######........................................................................#...............................................##
#####.................................................................#........................................................#
##...................................................................#.........................................................#
##......................................................................................###.......................#............#
#......................................................................................#####....................####...........#
##....................................................................................######....................####...........#
##.....................................................................................####.....###...........#####............#
###....................................................................................####.....####............###............#
###..........................................................#..........................##......###.............##.............#
##........................................................###...........................###......##..............##............#
##........................................................###............................#..............##.#.#.###.............#
#...........................................................#............................#.............############............#
##.......................................................................................................#.#.#.###............##
#.............................................................................................................................##
##...........................................................................................................................###
#............................................................................................................................###
##..........#................................................................................................................###
##..........#................................................................................................................###
###.......###.................................................................................................................##
###.......#...................................................................................................................##
##.......##....................................................................##.#............................................#
##..............................................................................#.##..........................................##
#..............................................................................................................................#
##.........................##.................................................................................................##
#...................#.#.######.................................................................................................#
#..................##########.................................................................................................##
#...................##########................................................................................................##
#...................#########.................................................................................................##
#.....................###.####..................................................##............................................##
#...........................#..................................................#####..........................................##
#...........................##.................................................#####..........................................##
#...........................##..................................................####.........................................###
#...........................##..................................................####.........................................###
#...........................#...................................................###..........................................###
##...............................................................................#............................................##
##............................................................................................................................##
##............................................................................................................................##
##............................................................................................................................##
##............................................................................................................................##
###............................................................................................................................#
##...............................................................#............................................................##
###.............................................................##.............................................................#
##............................................................................................................................##
###............................................................................................................................#
##...................................................................................................................##........#
##.............##................##................................................................................####........#
##............###...............###................................................................................##..........#
##............##.................##............................................................................................#
#............###...............................................................................................................#
##...........###.........##....................................................................................................#
#...........###.........####.......................................................................#...........................#
##...........##.........####......................................................................####.........................#
#........................###...........................................#...........................###.........................#
#..........................#...........................................###.........................###........................##
#........................................................................#..........................#.........................##
#..................................................................................................#.........................###
##.................................................................................................#.........................###
#.................................................................................................##..........................##
##............................................................................................................................##
#.............................................................................................................................##
##............................................................................................................................##
##.......................##...................................................................................................##
##.....................######.................................................................................................##
#......................########...............................................................................................##
##.......................#.##########..............#..........................................................................##
#............................##########...........###.........................................................................##
#..............................#########.....................................................................................###
#................................########................................####................................................###
#...................................####.................................###........#........................................###
#.....................................#...................................#......######.............................##......####
#.................................................................................###...............................#.......####
#.......................#...................................................................................................####
#......................###..........................#.......................................................................####
#......................###.........................###.......................................................................###
#......................###...................................................................................................###
##......................#.....................................................................................................##
#.........##...................................................................................................................#
##........##............................................................E......................................................#
#.........##...................................................................................................................#
##........###.....................................................................###..........................................#
##........###.....................................................................##...........................................#
##........####.................................................................................................................#
##.......####..................................................................................................................#
#........###..................................................................................................................##
##......##....................................................................................................................##
#............................................................###............................................................####
##.........................................................#####............................................................####
#..........................................................#####............................................................####
###......................................................######...............................#..............................###
###....................................................#########.............................###.............................###
#####.................................................#########..............................###..............................##
######.........................#########.#.#.#.#.#.##############.....#.#.#....#...........#######........####.#.#.###......####
################################################################################################################################
