################################################################################################################################
#####....................................................................................................................#.#####
#####.....##############................##########.....#####.....#####............#################................#####.....###
#####.....#######.#####..........................#.....#.####......#................#############..................####.......##
####.......####....###..........#..................#.#....###.......................#####............................##........#
####.....######.....#..........####................#####..#####.......................#..............................##.......##
####.....######................####................#####...####......................##.......................#......##........#
######.#######................#####...............######...######...........................................#####...###.......##
##############.................####.................###......###............................................#######.####.......#
#############..................####..............#####.......####......................................#.#.############......###
#############..................#.#...........................###......................................###################...####
############.......................................##........###.....................................#######.....###############
###########.........................................##........#..........................###.........#######.....###############
#########..........................................####..................................###........######.........#############
#########...........................................####..................................###........######........#############
###########........................................#####...........................................########..........###########
############........................................#####............#.............................########..........###########
#################..................................######..........#####..........................##########...........#########
###########...####.................................#######..........#######.......................#####................#########
#########......###.................................######............########.....................###...................########
#########........#..................................####...............#######...........................................###.###
#########...............................................................#####..................................................#
#########.................................................................####........#........................................#
####.#.####...............................................................###........###.......................................#
####....###......................#.........................................###......####.......................................#
##........###...................####......................................#####.....###...............##.......................#
##........###.....................#.......................................######..#####...............##.......................#
#...........##............................................................############.........................................#
#...........##.............................................................############........................................#
#............................................................................##########.......................................##
#.....................#########................###................................####.........................................#
#....................############............#####..................................#.........#...........##..................##
##...................############............####.............###.............................##..........####.................#
##...####.............###########..............#.............####.........................................####................##
#########.............#####...##.............................###...........................................#####...............#
#########...............##...........................#.......#.............................................#####..............##
######................................S.............##.#.................................#.................#######.............#
####...........###......................###........######..............................#####................###...##..........##
##..............##.....................###..........#####...................####.......######..............###...###..........##
##.............####....................##..........#######...................#####.....#####...............###.....#..........##
#..............###....................##...........######...................#######......#...............#####................##
#...............###...................#.............######....................####......................######................##
###.............###...........###....##.............#####.......................#.......................#######...............##
###..............##.........######..................#####...............................................#######.............####
#####.............#.........######...................####................................................######.............####
#####.............#........#######..........#........###.................................................#####...............###
######....................###..###..........##........#..................###..............................####.................#
######....................##................###..........................####........###...................#...................#
#####...............##..####.........##.....###..........................####.........####.....................................#
###...........###.##########.........##.....####..........................##............###....................................#
##............###.###########.......##.......##...........................................#...................................##
#..............####.#.######........###.....................#.................................................................##
#.......................#####.......###....................###...............................................................###
#..........................#.......####....................###..............................................................####
#..........................###.....#####.............#......###...............................................#.............####
#...........................##......####............##......###.............................................#####..........#####
#...................................####...........####.....####..............##..............................#####.........####
#...................................###............###......####............#####...............................#########.######
#...................................####..........####......###.............####..................................##############
#...................................###...........###......#####............#.......................................#######.#.##
#............#......................####.........####......####.......................................................###.....##
##.........###......................###..........####......#####...............................................................#
#..........#........................###...........###.......###......######...................................................##
##.................................###...........####.......###.....#######.................#...................##.............#
##................................................#####......#......#########..............##...................##............##
#####...............................................###.....##......##########................................####.......#.....#
######..............................................###.............###########..................#.#.######.#.######.....##...##
######..................#.............................#.............##########..................####################...........#
#####.................####..........................................###.#.####.................######################.........##
###..................######..........................................#.....###..................########.############.........##
###.................#######...........................##....................##...................###.#.....##########.........##
##..................##.####...........................###....................#..............................#########.........##
###................###...#...........................####...................##..............................###.#####.........##
###..................................................####...................###.............................#.....####........##
###..................................................##..................######...............#####........###.....###........##
###................#...........#........................................#######..............######.........##................##
###.##.......###...###.......#####......................................#####.................######.......###................##
###.##.......###########...########.....................................#####.................######.......####...............##
###..#.......#####################.......................................##...................######.......###................##
###............####################...............................................#......#....######......####................##
###............#######..................................#.......................####################.......###................##
###.............######................................####....................######################........#.........###......#
###............######.................................####...................###.#.##################.................####.....#
###............#####....................................##...................##........##############..................###.....#
####..........#####.....................................................................######.#.#####.........................#
####..........####......................................................................####.......###.........................#
####..........#####..................#..................................................####.......##..........................#
####............##...................##................................................###.....................................#
##...................................###...............................................###.....................................#
##...................................####.....................................##......###.....................................##
#....................................#####......#............................####.....##............................#..........#
##....................................#####.#.#####..........................###......##...........................###........##
#.......................................#.##########.........................###......##..........................####........##
#..............................##.#........########..........................##......###...........................#........####
#...........................########.........#######.........................##......###....................................####
#..........................#########...........#####.........................###...#####...................................#####
#.......................#############............###........................####.#.#####.........................#.........#####
#......................##############..............#.........................###########........................##........######
#......................###############.........................................#######.........................####........#####
##.........###.........###############..........................................#######.........................###........#####
##.......######..........#############.........................................#########......................#####.........####
###........#####.........#############.........................................###########....................#####.........####
###........#####..........############.......####..............................########.#...................#######.........####
####........####.........###############....#####..............................######...................#.#########.........####
####........####..........###########....#.#######..............................#####..................####.....###..........###
####.........####........##########....###########..............................#####..................##.......###............#
####.........####........#########......#####.#.#................................#####........................................##
###...........####........######.........##......................................####.........................................##
####..........####.........#.#.............................#.....................#####........................................##
###...........####........................................###.....................###.........................................##
#####..........##................##.......................###......................####.#......................................#
#######.........................###........................###.......................###...............................#......##
######.......................#.#####.......................##..........................................................##......#
######......................#######...............................................................##..........................##
####........................########..............................................................##...........................#
#####.......................#######..............................................................####........................###
####.........................######....................................#..........................##.........................###
#####.........................######.................................###...........#........................................####
####....###..........#.........####...............................................###........................E..............####
#####...####.........###........####..........##.................................#####......................................####
###.....####.........###........####.....########................................#####.......................................###
###...................###.......#####....########................................#####......................................####
###......##..........####.......####.....#########...#............................####......................................####
####.....##....#......####.....#####....##########.#####............##............####......................................####
####.#.###########..###############..#.###################.#.##.#.#.###...........####..........####.......................#####
####################################.###################################.#.#.....######........######..............#.##.########
##############################################################################.#.######.#.#.##############.#.#.#################
################################################################################################################################
