################################################################################################################################
################################################################################################################################
################################################################################################################################
################################################################################################################################
################################################################################################################################
################################################################################################################################
################################################################################################################################
################################################################################################################################
################################################################################################################################
################################################################################################################################
################################################################################################################################
################################################################################################################################
################################################################################################################################
################################################################################################################################
################################################################################################################################
################################################################################################################################
################################################################################################################################
################################################################################################################################
###############################################################################################################.################
###############################################################################################################.################
###############################################################################################################.################
###############################################################################################################.################
###############################################################################################################.################
###############################################################################################################.################
###############################################################################################################.################
###############################################################################################################.################
###############################################################################################################.################
###############################################################################################################.################
###############################################################################################################.################
###############################################################################################################.################
###############################################################################################################.################
################################################################################################################################
################################################################################################################################
################################################################################################################################
################################################################################################################################
################################################################################################################################
################################################################################################################################
################################################################################################################################
##########################################################################......################################################
################################################################.#########......################################################
################################################################.#########......################################################
################################################################.#########......################################################
################################################################.#########......################################################
################################################################.#########......################################################
##########################################################.............#########################################################
########################################################.................#######################################################
######################################################.........S...........#####################################################
####################################################.........................###################################################
###################################################...........................##################################################
##################################################.............................#################################################
#################################################...............................################################################
################################################.................................###############################################
###############################################...................................##############################################
###############################################...................................##############################################
##############################################.....................................#############################################
##############################################.....................................#############################################
#############################################.......................................############################################
#############################################.......................................############################################
############################################.........................................###########################################
############################################.........................................###########################################
############################################.........................................###########################################
############################################.........................................###########################################
############################################.........................................###########################################
############################################.........................................###########################################
#######################################...................................................######################################
############################################.........................................###########################################
############################################.........................................###########################################
############################################.........................................###########################################
############################################.........................................###########################################
############################################.........................................###########################################
############################################.........................................###########################################
#############################################.......................................############################################
#########################################.###.......................................############################################
#########################################.####.....................................#############################################
#########################################.####.....................................#############################################
#########################################.#####...................................##############################################
#########################################.#####...E...............................##############################################
#########################################.######.................................###############################################
#################################################...............................################################################
##################################################.............................#################################################
###################################################...........................##################################################
####################################################.........................###################################################
######################################################.....................#####################################################
########################################################.................#######################################################
##########################################################.............#########################################################
################################################################.###############################################################
################################################################.###############################################################
################################################################.###############################################################
################################################################.###############################################################
################################################################.###############################################################
################################################################################################################################
################################################################################################################################
#####################################............###############################################################################
#####################################............##########################################......###############################
#####################################............###############################################################################
#####################################............###############################################################################
#####################################............###############################################################################
#####################################............###############################################################################
#####################################............###############################################################################
#####################################............###############################################################################
#####################################............###############################################################################
#####################################............###############################################################################
#####################################............###############################################################################
#####################################............###############################################################################
################################################################################################################################
################################################################################################################################
################################################################################################################################
################################################################################################################################
################################################################################################################################
################################################################################################################################
################################################################################################################################
################################################################################################################################
################################################################################################################################
################################################################################################################################
################################################################################################################################
################################################################################################################################
################################################################################################################################
################################################################################################################################
################################################################################################################################
################################################################################################################################
################################################################################################################################
################################################################################################################################
################################################################################################################################
################################################################################################################################
################################################################################################################################
################################################################################################################################
################################################################################################################################
################################################################################################################################
