################################################################################################################################
##########..........................#########################################################################..#################
#####.........##################.....#########.....##################.....#####.....######.......##..###..##........##..########
####..........####..###########.......#######.......###########...........####.......####................................#######
####..........###....##########.........#####.......##########............###.........##.....##...........................######
#####........###.....###########..........###.......##########...........####...............####............#####..........#####
#####.......###......###########...........##........#########...........####...............####...........#######..........####
#####......###.......##########............##..........######.............###................##.............######...........###
#####.....###........#######..............##............####..............###..................................##............###
#####....####.........#####...............##............###...............###................................................###
######..######.........####............................###...............####...............................................####
###############........####............................###..............#####...............................................####
#################.......##.............................###.............######................................................###
###.....##########.............##.....................###..............#####...............##.................................##
##.......#########............##########.............####...............##................####.................###............##
##......##########............###########............###..................................#####...............#####..........###
##.....###########...........############..................................................#####.............######.........####
##....#############......##########...##.....................................................####...........#######........#####
##....##############.....#########.......................................................#....####..........########......######
##.....##..####..###.....#########....................................##................###....#####........####################
##..........##..........###########..................................####...............###......###........####################
##....................##############.................................####...............###.................####################
##...................###############...................###..........####.................###..........#....###########..########
###..................###############....##.............#####......####...................######......###...####..........#######
######...............###############...####............#####.....####.....................######....####.................#######
#######...##............############..#####...............##.....###......................######....###...................######
#######..####............####..#####..#####......................####....................######.....###............####.....####
######..#####...................###...#####.......##.............#########........###....######.....###...........#####......###
#####...######........................#####.......###...###.....############......###....######......###..........####.......###
####.....######......................#######......###...####....#############......###....#####......###..........####.......###
###........#####....................########.......#....#####....############.......###....#####.....##............###......####
###.........#####......................#..##............#####.....##########.........#.......####....##............###......####
##..........#####..................####....##...........#####......#########.................#####..####...........###.......###
#............####...................##......##..##.......####.......#########.............###############..........###.......###
#............#####.......####.....S.........#######.......##.........#########...###.....################.........#####.....####
##...........#####.......#####.............########..................#################...######.......###.........#####....#####
####..........####.......######.......##############..................#################...####.....................####....#####
#####..........###...........###.....######...########..........##............##########...###.............##.......####....####
#####.........................###...###........#.######........###.............#########...####...........####.......###....####
####..........................########...........#######........##...............#######...####............####.......###..#####
###...........................#######..............#####...........................####...######............######....##########
###............................######..............####.............................##....#######............######....#########
###.......###...................####.............######.......................###..........#######............######.....#######
####......###..................................########.........#............#####...........####.............######........####
#####....................###....................######.........#####.........#####.............................####..........###
#####....................###....................................#####.......#####......................................##....###
######...................###......................................###......####......................####.............#####...##
#######......................................###...................##.....####........###...........######............######.###
######......................................#####.........................####........####..........#######............#########
#####.......................................#####........................######.......####..........########............########
###...............#.........................#####........................######.......####...........########.....###....#######
##...............###............##...........###........................########......####............#######....#####....######
##........##.....###...........#######.............................############.......#####............######....#####.....#####
##.......#####..###............########........................############............#######........#######....######....#####
##......##########.............#########.................##...############..............#########..#########.....######....#####
##...#############..............#########...............###############..................##############.............##......####
#...##############...............########.....##.......###############.....................###########......................####
#...##############..................####.....###.......###############......................#########.......................####
#...##############...................###....####........##############.............#####.....#######.......................#####
##...#############....................#########..........##....######.............#######.................................######
##....############.......#####........########..................####.............########......................####......#######
###...#############.....#######..##...########.......##..........................#########....................######.....#######
###....#############....#######..###...#######......#####........................##########....................#####......######
####.....############....#####....##...#######......######.......................###########...........##.......#####......#####
#####.....##########.....####.....##....######.......#####.......................#####...##...........####.......#######....####
######....#######........####....###....######.......####.........####............###.................######.....########....###
######....######.........###.....###.....######.......###.........#######.............................#######.....########...###
######.....#####.........##.......#......######........##........#########.............................#####.......#######...###
#####....................##...............#####.................##########...........................................####.....##
####............##.......##...............######...............###########.......................####.........................##
###............###.......###..............######............##########...##...................########.......................###
##..............#........####.............#####............###########.......................########......................#####
##........##.............#####.......##...###........###....####...###.......................#######......................######
##.......####............#####.......#...####........####...........###......................#######......................######
###......####.............###...........#####.........####..........###............###.......#######.......................#####
######..#####...........................#####..........###..........###............###.......###..##.........................###
############...................###.......###...........###..........####...........###.......##....#..........................##
##########....................####.....................####..........####.........####.............##..............##.........##
#########......................##......................####..........####.........###.............................####........##
#########...............##.............................####.........#####...##....##.............................######......###
##########.............####............................####........###########..................................#########....###
###########...........######..........#................####......############..................##..............###########...###
############.........########........###..............#####.....#############..................##............#####....####...###
###..####.##........###########......####.............####....##############...................##...........#####......###....##
###..###...##..#################.....#####.............##.....##############................................#####......###....##
####..###...#####################...#####.......###..............##########.................................####........###..###
####..###....#####......####..##########......######..............########..................................####.........#######
####..###.....##.........##....########......#######...............######.....##...........................####...........######
###...###.......................######.......#######................#####.....###.........................####.............#####
##...####.....................................#####....##............###.....####..........................#.................###
##...#####............###.......................##....####...........###.....####.............................................##
##....######.........#####...........................#####...........###......##....###................................#......##
##....#######........#####..........................#####.....##.....###...........#####.........######...............###.....##
###...#######.........####.........................#####.....####....###..........######.........########.............###.....##
###....#####...........###.........................####.....######....#..........######..........#########.............##....###
###............................##...................##.......######..............#####...........#########...................###
###...........................####.......##.....................####.............#####...........#######.....................###
##...................##......#####....######.....................####.............###.......#....####...............###......###
##..................####.....#####....######.....................#########.................###..####...........#########......##
###.................#####....####.....#######...................##########.................#########..........#########.......##
############........######..####..........####..................###....###.................########............#######........##
#############.......############...........##....................#............#####.......#########.............######.........#
##############.....############..............................................#######......#########......##......######........#
##############.....############....................#####.....................#######......##########....####......#####.......##
#########..##......###########....................######......................#####.......##....###############....####.......##
########...........#######........................######.........................................###############....##........##
########............#####.........................####.........##......##.........................#######...###...............##
#######...............##.........................####.........####....###.....................................................##
######..........................................#####.....########...####.....................................................##
###.................................###.........######...##########..###......................................................##
##.................................#####.........#####...##########...#..................##....................................#
##................................######......#...#####...#########.....................####....................##.............#
##..................###..........#######.....###.....###....######...........###........#####..................####............#
###................####...##.....#######......###.....###....#####...........###.........#####.................#####...........#
####.......##....#####...####....######.......#####....#......####..........####..........######..............#######.........##
####......#########......####.....####.........#####...........##...........#####..........######.............#######........###
####......########........####.....###..........####.................##.....#####............####......##.....#######........###
#####.....########.........###...................####...............####.....#####............####.....##.....########.......###
######.....#######................................######............####......#####...........#######........#########.......###
########......#####...E............................######...........####......#########........######.......###########.....####
#########......#####........................###.....######..........#####......#########.......####........#############..######
##########......#####.................#......#.......######.........#####......########........###.........#####################
###########.....#####................###..............#####..........###.......####............###....#.....##......############
###########.....#####.......##......###................####.....#.....##.......###.............###...###.............###########
############...######.......###....####................####....###....##......####.............###....##.............###########
#############.########......############.......####....#####..#####..####....#####........#########..####...........############
##########################.###############################################..#######......###################...#################
################################################################################################################################
