################################################################################################################################
###...############.......#####################......############........#.#.#.###################################.....#####.#.##
##....#####....#..............#########...............#####.##..................######..........#####........#.........###....##
##.....###.....................#######................###........................####..........................................#
##....####......................######...........................................####.........................................##
###..####.......................######...........................................###.........................................###
##..#####...........#............#####...........................................###....................................##...###
##.#####...........####......#.#######...........................................#......................................##...###
#....###...........#.###...###########..............#.........................................##...............................#
#....##...####........###.############............#####........................................#..............................##
#.....##########...........###########...........#####.........................................##..............................#
#.......#######.........####.##....##...........######.........................................................................#
##......#######.........##......................#####..........................#...............................................#
##.......######........###......................#.#......................#....####.............................................#
###.......#####.................................#......................###....####.............................................#
###.......#####................................#.......................#........##....................##.......................#
####........###.......................................................................................##.......................#
####...........................................................................................................................#
###............................................................................................................................#
##.............................................................................................................................#
##..............................................#...................###........................................................#
#.....................#........................###..................####.......................................................#
##...................###.......................####..................#####.....................................................#
#.....................##.......................####..................#####....................................................##
##.........S....................................###...................####.....................................................#
#...............................................##....................####.......###.................###.......................#
##.............................................................###...####.........####.............######.......#..............#
#...............................#..............................##########..........###...........######.#.......#..............#
##...............##...........####.......##...................##########.......................####.......#....######..........#
#...............###...........##.##.....####..................##########.....................####.........####...####..........#
##..............####....................####................###########.....................######.......#####.....#...........#
##..............####.....................####...............############.....................#####.......#####.................#
###............#####.....................###..............#############.......................#####......####..................#
####...........######....................................############...........................####.....####..................#
######..........#.###....................................########................................###......##...................#
#######............###.....................................######..................##............####..........................#
#########...........##......................................###....................###...........###...........................#
#########........................................................................................####..........................#
##########..................................##...................................................###.........................###
###########.................................##..................................................#####....................#######
###########....................................................................................######....................#######
###########........#...........................................................................#####......................######
##########.......####..................................................#................##.#.#####...........................###
#########........####..............................##................###................#######................................#
########..........##...............................#...............#####................########...............................#
#######...........................................................######.................######................................#
#######..........................................................#####....................######...............................#
########........................................................######....................#####................................#
####.#...........................................................###.......................#..........#........................#
##...............................................................###.................................##.......................##
##.................................................................#................................#####....................###
##.................................................................####.............................#####...................####
##.................................................................####............................####....................#####
#......................................................##........######...................#................................#####
##......................#..............................##........###......................###......##.......................####
#.....................###.......###.#.###........................#.........................##......##...........#...........####
###...................##........##########...................................................#....##............##............##
###..................###........##########..................................................................#...#.............##
####.................##.........##########................................................................###.#.#..............#
####................###........########.##.................................................................######..............#
####................###.......#####.........................................................................######.............#
####................###......####............................................................................####..............#
#####...............#####...####............................................................#.................####.............#
######..............###########.........................................................#######...............###..............#
########............###########........................................................########................##..............#
###.#.##...........###########.........................................................#########.............#.#..............##
###................#####.#.###..................................................##......########...........###.#..............##
##.................#####.........................#.............................###........#.##...........#####.....####......###
####................##...........................##............................###......................######......####.....###
####.....................................................###............##.....###.......................###..........#......###
####...................##................................###...........##.......#......................#####.................###
####.................######.#............................####..........##..............................####..................###
##...................#########............................##...........##................#......E.....######.................###
##..................##########............................###..........#................###..........######.................####
#.....##...........##########..............................#.............................##..........######..................###
#....#####.........###.#####...............................###..........................####.........######.................####
#...######.........##....###...................#.#...........##.........................####.........#####..................####
###########...................................#######.#......###........................#####........#####................######
#######.#.#.................................############......##.......................######.......######................######
#######...#................................#############...............................######......######.........##....########
######..............................##.....#############...............................#####......####.#.........###############
######..............................####...#############.................................#........##.............##########...##
######.............................#####...############..........................................###..............###...#......#
######....##.......................#####.....#########...........................................##............................#
########.####.....................######.......#####............................................###............................#
############...............#......######.......#####............................................##.......##....................#
############..............####.....####.........##.......................................................#.....................#
##########...............#######....####.......###...........................................................................###
########..................#######....##........#............................................................................####
########....................####..............##.............####.................###......................................#####
######........................................................#####..............#####.......................###............####
#####........................................................#######............######.......................####............###
#####.........................................................#######..........#######.......................###.............###
####.........................................................#######............####.........................#...............###
####..........................................................##..###............#..........................................####
#####.............................................###........##.....#....................................#.................#####
#####............................................#####..............###................................###...............#######
######.........................................########..............#######.#........................####..............########
###............................................#######................##########......................###.............##########
######........................................######.....................######........................##.............##########
#####...........................#......#......#####........................##.........................................#####.####
#####.........###..............####....#......####......................................................................#.....##
####...........###.............#########......###.............................................................................##
###............####............####.####......................................................................................##
##.............#####...........##...####..........................................................................#...........##
##.............#######.........##...............................................................................###...........##
#..............#########.......#...............................................................................####...........##
##.............########.......................................................................................####............##
#.......##.......................................###..........................................................####...........###
###.....##.........................................#...........................................................#........#.#.####
###......#.............................................................................................................#########
###...................................................####.............................................................#########
##................................................#...######............................................................########
##........................###...................#############..............................................................#####
##.......................#####.................###############...............................................................###
#........................###..................####################...........................................................###
##...........................................#######........#######...........................................................##
##...........................................#######..........######........................##...........#.#.#.........###....##
####.........................................#####.............####.........................##..........#######.......####....##
####..........................................###..............####.........................###...........######......####....##
####............................................................##..........................##..............####.....###.....###
###.......................................................................##............#######..............###.....###.....###
###.......................................................................##.............#######..............###...###.....####
###.....##...............................................................###...............######.............##....###.....####
#####.#####..............................................................####..............#######............###...#####.######
#############........########.#.###.............##.#.#.#................######.#.#..........########.#.#.....###################
################.#.###################.#.#.################............##############......#####################################
################################################################################################################################
