################################################################################################################################
####.#.#.####################.#.##########.#.#.#....#######.#.#.#.########.#.##########......#.############.########.#.#.#.#####
###...........######............#########............####.......................#######..........#######......###...........####
##............####................#######...........####........................######.............###.......................###
#..............###.................#####............###...........................#####.......................................##
##............##.....................####..........##...............................##.........................................#
#.............##.......................#......................................................................................##
##............##...............................................................##..............................................#
#............###..........###..................................................##..............................................#
##...........###.........####............#....................................................#................................#
#.............###.........##...........####..................................................###...............................#
##...........####.......................###.................................................####...............................#
#.............###............................................................................##................................#
##.............#..............................................................................#................................#
###............................................................................................................................#
###............................................................................................................................#
###............................................................................................................................#
##.....................................................................................##...........##.........................#
##.....................................................................................#...........###.........................#
#..............................................................................#.#.............................................#
#..............................................................................................................................#
#..............................................................................................................................#
#..............................................................................................................................#
#............................................................................................................................###
#............................................................................................................................###
#...........##.......................................##.............................................................#.......####
#...........##..............................................................................................................####
#...........#................................................................................................................###
#............................................................................................................................###
##................................................................................................##.........................###
###..............................................................................................####........................###
###..............................................................................................#####.......................###
####.............................................................................................#####.......................###
####.............................................................................................#####.......................###
#####.............................................................................................#.#.......................####
#####........S...............................................................................................................###
####..........................................................................................###............................###
###...........................................................................................###.............................##
##............................................................................................####...................##......###
##.............................................................................................##....................##.......##
#...................................................................................................................##.......###
#.............................................................................................................................##
#.............................................................................................................................##
#.............#................................................................................................................#
#...........#####.............................................................................................................##
#.........########.............................................................................................................#
#........##########..........................................................###..............................................##
##.......#########..........................................................####...............................................#
##........###...............................................................####......#.......................................##
###..........................................................................##......####......................................#
##...........................................................................###.....####.....................................##
##............................................................................#......######....................................#
#............................................................................##.......######..................................##
##...........................................#...............................##.........####...................................#
##..........................................###.............................###...........#...................................##
####.....................##.................###.............................##....................................##...........#
######..................###.......................................................................................##...........#
######...................#.......................................................................................####..........#
######..........##................##..............................................................................##...........#
####...........##.................##..............................................................................###..........#
####...........###................................................................................................####.........#
###...........####................................................................................................###..........#
###............####..............................................................................................#####.........#
##........................................................................................###...................#####.........##
##.........................................................................................##...................######........##
##.................................................................................................................##.........##
#.............................................................................................................................##
##............................................................................................................................##
#.............................................................................................................................##
##................................................#...........................................................................##
#................................................####.........................................................................##
#..................................................##............................#............................................##
#................................###.............................#..............####..........................................##
#...............................####..................###........###............###............................................#
#...............................####...................##........####....................###..................................##
#...............................###....................###........###...................#####..................................#
#................................#.....................###........###...................#####.................................##
#......................................................####.......###....................##....................................#
#.............................................#........###.......###..........................................................##
#.............................................##.......###....................................................................##
#......................................................###...................................................................###
#.......................................................#....................................................................###
#..........................................................................................................................#####
#..........................................................................................................................#####
#.........................................................................................................................######
#..........................................................................................................................#####
#......................#..................................................................................................######
##...................#####................................................................................................######
##...................#####.........................................#.........................................###..........######
###................#########.......................................######.....................................##.........#######
##.................#######.........................................######....................................####.........######
###................#................................................###......................................###..........######
##..........................................................................................................####...........#####
###.......................................................................................................####...............###
###.......................................................................................................##..................##
####....##..............................................................................................................#......#
####....#..............................................................................................................##.....##
######................................................................................##..............................####.....#
######................................................................................#...............................####....##
######...............................................................................###.............................######....#
#####............................###.#................................................##..............................#.#.##.###
#####.............................#####...............................................###..................................#####
####.............................######................................................##..........#........................####
####..............................####.................###..............................##........###........................###
###................................#..................#######.##................#........#.......#####........................##
##.....................................................#########..............####.......##.......###.........................##
###......................................................######..............#####......##....................................##
##..........................................................###..............#####......##....................................##
###.........................................................###..............#######..###......................................#
###............................................................................##########.....................................##
###..............................................................................#########................##...................#
###.............................................................................##########.#.............###..................##
##...............................................................................############.............#....................#
#................................####...........................................###########.#.................................##
##................#..............##..............................................#######.......................................#
#.................##.........................###........##........................######......................................##
##...............###..........................##.......####............E............##.........................................#
#................###....................................####...................................................................#
##.............#####....................................####...................................................................#
##............######.....................................####..................................................................#
###...........#####........................................##..................................................................#
###............................................................................................................................#
###............................................................................................................................#
###............................................#...............................................................................#
###..........................................####.............................................................................##
####...........###.#.........................####........#.....................####..........................................###
####.#.#.#.#.##########.#.#.###.#.#.###############.#.######..............##.#.#####......####............................#.####
################################################################################################################################
