################################################################################################################################
################################################################################################################################
################################################################################################################################
################################################################################################################################
################################################################################################################################
################################################################################################################################
################################################################################################################################
################################################################################################################################
################################################################################################################################
################################################################################################################################
################################################################################################################################
#############################################.##################################################################################
#############################################.##################################################################################
#############################################.##################################################################################
#############################################.###########.######################################################################
#############################################.########.......###################################################################
#############################################.######...........#################################################################
#..................##########################.#####.............################################################################
#..................##########################.#####.............################################################################
#..................##########################.####...............###############################################################
#..................##########################.####...............###############################################################
#..................##########################.####...............###############################################################
#..................##########################.###.................##############################################################
#..................##########################.####...............###############################################################
#..................##########################.####...............###############################################################
#..................##########################.####...............###############################################################
#..................##########################.#####.............################################################################
#..................################################.............################################################################
#..................#################################...........#################################################################
#..................###################################.......###################################################################
#..................######################################.######################################################################
#..................#############################################################################################################
################################################################################################################################
################################################################################################################################
################################################################################################################################
################################################################################################################################
################################################################################################################################
################################################################################################################################
################################################################################################################################
################################################################################################################################
################################################################################################################################
################################################################################################################################
################################################################################################################################
################################################################################################################################
################################################################################################################################
################################################################################################################################
################################################################################################################################
################################################################################################################################
################################################################################################################################
################################################################################################################################
#########################################################################.......################################################
#########################################################################.......################################################
#########################################################################.......################################################
#########################################################################.......################################################
#########################################################################.......################################################
#########################################################################.......################################################
#########################################################################.......################################################
#########################################################################.......################################################
#########################################################################.......################################################
#########################################################################.......################################################
#########################################################################.......################################################
#########################################################################.......################################################
#########################################################################.......################################################
#########################################################################.......################################################
#########################################################################.......################################################
#########################################################################.......################################################
#########################################################################.......################################################
#########################################################################.......################################################
####################################.............########################.......################################################
#########################################################################.......################################################
################################################################################################################################
#########################################################.######################################################################
#####################################################.........##################################################################
###################################################.............################################################################
##################################################...............###############################################################
#################################################.................##############################################################
################################################...................#############################################################
################################################...................#############################################################
###############################################.....................############################################################
############################...........########.....................############################################################
############################...........########...................S.############################################################
############################...........########.....................############################################################
############################...........#######.......................###########################################################
############################...........########.....................############################################################
############################...........########.....................############################################################
############################...........########.....................############################################################
############################...........########.....................############################################################
############################...........#########...................#############################################################
############################...........#########...................#############################################################
############################...........##########........E........##############################################################
############################...........###########...............###############################################################
############################...........############.............################################################################
#####################################################.........##################################################################
#########################################################.######################################################################
################################################################################################################################
################################################################################################################################
################################################################################################################################
################################################################################################################################
################################################################################################################################
################################################################################################################################
################################################################################################################################
################################################################################################################################
################################################################################################################################
################################################################################################################################
################################################################################################################################
###################################.....########################################################################################
################################################################################################################################
################################################################################################################################
################################################################################################################################
################################################################################################################################
################################################################################################################################
################################################################################################################################
################################################################################################################################
################################################################################################################################
################################################################################################################################
################################################################################################################################
################################################################################################################################
################################################################################################################################
################################################################################################################################
################################################################################################################################
################################################################################################################################
################################################################################################################################
################################################################################################################################
################################################################################################################################
################################################################################################################################
################################################################################################################################
################################################################################################################################
################################################################################################################################
