################################################################################################################################
######......########################.#.#.########.#.#.##########.#.###########.#.#.######.#.#####........######............#####
#####..........##############.............######........#.#.####......########........#....................##................###
####.............###########................##..............##........######.................................................###
###................###...###...........................................#####..................................................##
##..................##...###.............................S.............###...................................................###
###......................##.............................................##....................................................##
##........................#............................###.............###.....................................................#
##...................................................######............###.....................................................#
##..................................................#######..........#####.....................................................#
#................................................##########..........#####.....................................................#
##...............................................#########.........##...###....................................................#
#......................................................###........###.....#....................................................#
###...............................................................#.......##...................................................#
####..............................................................#............................................................#
####...............###.........................................................................................................#
###.................##...............................................................................#.........................#
##...........................................................................................#####.####.......................##
##...........................................................................................#########........................##
#..........................................................................................###########................##.......#
#.........................................................................................##########.................###......##
#..........................................................................................#########................####.......#
#..........................................................................................#######..................###.......##
#...........................................................................................######..................####.......#
#..................................#...........................................................#.....................##........#
#...................##.............##................................................................................###.......#
#..................####............##...................................................................#......................#
##..................###................................................................................###.....................#
##.....................................................................................................####....................#
##.....................................................................................................####...................##
##......................................................................................................###................#####
##.....................................................................................................####................#####
##......................................................................................................###................#####
##......................................................................................................###..................###
##................##.....................................................................................##..................###
###...............##.............................................###.....................................##...................##
###.......#.......###........................................................................................................###
###.......##......##..........................................................................................................##
###.......###.......................................................................................................###.....####
##...................................................................................................................###.....###
##........................................................#............................................................#.....###
##.......................................................###..................................................................##
##.......................................................###...................................................................#
#.........................................................#....................................................................#
#.....................#........................................................................................................#
#.....................##.......................................................................................................#
#.....................###...............................................................#......................................#
#......................##..............................................................##......................................#
#......#...............................................................................###...................................###
#......##...............................................................................#.....................................##
#.....###....................................................................................................................###
#......#.......................................................................................................................#
#.............................................................................................................................##
#...........##......................................................#..........................................................#
##.........##......................................................###........................................................##
##..................................................................#.........................................................##
##.................................................................................................##.................##.....###
##.................................................................................................###................#......###
#.................................................................................................####................#.....####
##..................................###............................................................##...............#........###
#....................................##...........................................................#####.......###.#.##......####
##........####......................###............................................................####.......########.......###
#..........####......................#............................................................#####.......########......####
##.......######....................................................................................###.........###.#........####
#........#####..............................................................................................................####
##.....#####................................................................................................................####
#....#####....................................................................................................................##
##..####.....................................................................................................................###
#######.......................................................................................................................##
######................................................................##......................................................##
#####................................................................####......................................................#
#####.................................................................#.#......................................................#
#####...................................................................................###....................................#
####....................................................................................##.....................................#
####....................................................................................#......................................#
###............................................................................................................................#
##.............................................................................................................................#
##.............................................................................................................................#
##............................................................................................................................##
###...........................................................................................................................##
####..........................................................................................................................##
######............................................................................................................##.........###
######...........................................................................................................####.........##
##..............................................................................................................######.......###
##...............................................................................................................#####.......###
#................................................................................................................######.....####
##................................................................................................................#####.....####
#.................................................................................................................#####.....####
##..................................................................................................................#.........##
##............................................................................................................................##
#..............................................................................................................................#
#.....................................................................................#.......................#...............##
#....................................................................................##......................##................#
#...................................................................................####......................#...............##
#...................................................................................###........................................#
##.................................................................................###........................................##
##......................#..........................................................#...........................................#
##......................##.......................................................###..........................................##
#.....................#####......................................................##...........................................##
#.....................######....................................................##....................................#.......##
#....................########...........................................E........#..................................###......###
#....................#########.......................................................................................#........##
#....................########.................................................................................................##
##........##..........##..###.................................................................................................##
##......####..................................................................................................................##
##....######.........................#........................................................................................##
##...#######........................##.................................................................................#......##
##....######.........................#...............................................................................#####..####
##......#####......................................................................................................#############
#.........#........................................................................................................#############
##.................................................................................................................#############
#...................................................................................................................############
##...................................................................................................................#######..##
#........................................................................................................................#.....#
##.............................................................................................................................#
#..............................................................................................................................#
##.............................##..............................................................................................#
##.............................##..............................................................................................#
##.............................................................................................................................#
#..............................................................................................................................#
#..............................................................................................................................#
#..................##.............................................................#.#.#.#......................................#
#..................###..........................................................#########.....................................##
#...................###.................................##.....................##########......................................#
#.....####..........####.....#..........................##...................############.................................#...##
###...#####..........####.######........................####....##........################........................###...#####.##
###.###########....#########################..........##############.#.###########################.........#.#.######.#.########
################################################################################################################################
