################################################################################################################################
###############......###################..........#####....#####.#.#.#.#.####################.#.################################
#############..........#......########..............#......#...............###############........###......#####################
######S...#...................#.#.........................................################..........#......#########....########
#####.....................................................##................############....................########.....#######
####......................................................##...............######...####.............##....#########.......#####
###......................................................###................#####...................####.#.#########........####
###......................................................###.................###....................#########.#.###..........###
###......................................................###.................###...................#########.................###
####..................##.................................##...................##....................#######..................###
#####................###................................####..................##........................................#....###
######...............####...............................###.............................#..............................###....##
######...............###................................###.............................###............................###....##
######...............####................................#..............................####............................###....#
#######...............####...............#..............................................#####...........................###...##
######................#####.............###.............................................####.............................####.##
#######.................####...........###.................................###.........#####.............................#######
######..................####............###................................#####........##...............................#######
######...................###...........###..................................#####.........................................######
######..................###............####.................................#####............................................###
#####....................###...........###.............#......................###..................##.........................##
#####...................###...........###............####....................###..................####........................##
####.....................#.............##............####.....................##...................##.........................##
###...................................#................#..........................................###.........................##
##...................................##.......................................................................................##
##...................................##.......#..............................................####.............................##
##..................................##......####............................................####..............................##
##..................................##......####............................................#.................................##
##.........................................#####.................................................................##...........##
##.........................................#####.....###..................................................##......##..........##
##..........................................##.....######................................................###......##..........##
###................................................##.#.#................................................###......###.........##
####.....................................................................................................###......##..........##
######..................................................................................................###...................##
########........................................#.......................................................###...................##
#########..................................#######.....................................................###...................###
####.......................................#######.....................................................####..................###
##..............................#.###......######......................................................###...................###
##............................########......####........................................................####.................###
#................##..........#.#######...................................................................#####.................#
#.................#...............###.....................................................................#####...............##
#.................#...............####...............................................#.#.#.................###.................#
#..................................##...............................................########..............#####...............##
#................................####..............................................##########.............#####................#
#................................####..............................................###########...........########.............##
#...............................####..............................................####.########.........#########...........#.##
#................................#.......##.......................................##...########.........##.#######........######
##.......................................##......................................###.....###..###..............##........#######
##......................................##.......................................###.....###....##..........................#.##
###.....................................##......................................###............###............................##
###....................................##.......................................###............###.............................#
###............................................................................###............###..............................#
###............................................................................###............###..............................#
###............................................................................###.............#...............................#
###...........................................................................####.............................................#
##..............#.............................................#...............###......#.......................................#
##...........####...........#................................####............####.....###................................###.###
#..........######.........#####..............................#####...........###......##.................................#######
##.........####............#####..........#.#...............######...........###.....###...................................#####
#............................####.........####..............#######..........#..............................................####
##.............................#...........####.............######...........................................................###
##..........................................###.............#######..........................................................###
###..........................................................#####...........................................................###
###...........................................................####...........................................................###
##............................................................................................................................##
##............................................###.............................................................................##
##...........................................####..............................................................................#
#............................................###..............................................................................##
##..........................................####.......................##..................................##.............#.#.##
#............................................#..........................##................................####...........#######
##........................................................................................................###.............######
#.......###.#..............................................................................................###.............#####
##.....########............................................................................................###...............###
##......#######..............................................................................................#...............###
###.....#######...............................................................................................................##
##.......#####..................................................###..........................................................###
###.......##....................................................####.....................###.......................##.........##
##.............................................................#####....................#####.....................###.........##
##.................................###..........................##.#...................#######...................#####........##
#................................#####.................................................######.....................####........##
#................................######................................................#..........................####........##
#..................................#.#............................................................#.................###.......##
#.................................................................................................##................###......###
#...........#......................................................#.............................###.................#####....##
#.........####.....................................................#.............................#....................##########
##.......#####...................................................###..................................................#####...##
##......####........................................#..........####....................................................##.....##
##......####...........#............................#........####.............................................................##
##......####.........#####........................#.#........####..............................................................#
###......###........######........................#..........##...............................................................##
###......###........######........................#...........................................................................##
###.....................#........................##..........................................................................###
##................................................#............##...............................##...........................###
##..........................................#....##...........###..............................###..........................####
#..........................................##.................###................#.............#####..##.....................###
##...........................................................####...............##.............########......................###
#...........................................#................###................................#.#####......................###
###.........................................#.................###...................................#.........................##
#####......................................####...............................................................................##
######......................................###.................###...........................................................##
######......................................####.................###...........................................................#
#######................................#....####................####..........................................................##
##...#............#...................##.....####...............###...........................................................##
##....#.........#.#...................###...######..###.........###..........................................................###
##.............#####.........................#####..###........###.................####............................#.##......###
###.....#......#####........................############........##...............#######.........................###.#.......###
###....##.....#######.............#...........###...###.........#.................######.........................#####........##
####...####....#####............######..............####...........................######.......................#####........###
####.#######.....##............######.................##..E..........................####.......................######........##
###########.....................######................##.............................####......................######.........##
###.#######......................###...................##............................####......................#####..........##
###...####........................##...................##............................####.....................######...........#
##.....###.........................#...............................#.#...............####.....................####............##
###...............................................................####..............#####............###.....######............#
##..................................................................#.#...............####............###...######............##
##....................................................................................####..................######............##
##......................................................................................###.................#.#..............###
#...........................................................................................................................####
#........................................................................................................................#######
#...............................##.....................................................................................#########
#..............................####......##............................................................................#########
#...............................##......####...........................................................................###...###
#.......................................####...................................................................................#
#........................................###..................................................................................##
##.........####...........................##..............#......................##.............#............#................##
##........############.........#..........##............#####...................#####.........#####........#####.........#######
####.....##############.....######.......#####.#.#.#################......#.#.#.#####.#.###########......#######################
################################################################################################################################
