################################################################################################################################
################################################################################################################################
################################################################################################################################
################################################################################################################################
################################################################################################################################
################################################################################################################################
################################################################################################################################
################################################################################################################################
################################################################################################################################
################################################################################################################################
################################################################################################################################
################################################################################################################################
################################################################################################################################
################################################################################################################################
################################################################################################################################
################################################################################################################################
################################################################################################################################
################################################################################################################################
################################################################################################################################
################################################################################################################################
################################################################################################################################
################################################################################################################################
################################################################################################################################
################################################################################################################################
################################################################################################################################
################################################################################################################################
################################################################################################################################
################################################################################################################################
################################################################################################################################
################################################################################################################################
################################################################################################################################
################################################################################################################################
################################################################################################################################
################################################################################################################################
################################################################################################################################
################################################################################################################################
################################################################################################################################
################################################################################################################################
################################################################################################################################
################################################################.###############################################################
################################################################.###############################################################
################################################################.###############################################################
################################################################.###############################################################
################################################################.###############################################################
##########################################################.............#########################################################
########################################################.................#######################################################
######################################################.....................#####################################################
####################################################.........................###################################################
###################################################...........................##################################################
##################################################.................................#############################################
#################################################..................................#############################################
################################################...................................#############################################
###############################################....................................#############################################
###############################################....................................#############################################
##############################################......................S..............#############################################
##############################################.....................................#############################################
#############################################.......................................############################################
#############################################.......................................############################################
############################################.........................................###########################################
############################################.........................................###########################################
############################################.........................................###########################################
############################################.........................................###########################################
############################################.........................................###########################################
############################################.........................................###########################################
#######################################...................................................######################################
############################################.........................................###########################################
############################################.........................................###########################################
############################################.........................................###########################################
############################################.........................................###########################################
############################################.........................................##############.############################
############################################.........................................##############.############################
#############################################.......................................###############.############################
#############################################.......................................###############.############################
##############################################.....................................################.############################
##############################################.....................................################.############################
###############################################...................................##############################################
###############################################...................................##############################################
################################################.................................###############################################
#################################################...............................################################################
##################################################.............................#################################################
###################################################...........................##################################################
####################################################.........................###################################################
######################################################.....................###########...........###############################
########################################################.................#############...........###############################
##########################################################.............###############...........###############################
################################################################E#####################...........###############################
################################################################.#####################...........###############################
#############################################################.##.#####################...........###############################
#############################################################.##.#####################...........###############################
#############################################################.##.#####################...........###############################
#############################################################.########################...........###############################
#############################################################.########################...........###############################
#############################################################.########################...........###############################
#############################################################.##################################################################
#############################################################.##################################################################
#############################################################.##################################################################
#############################################################.##################################################################
#############################################################.##################################################################
#############################################################.##################################################################
#############################################################.##################################################################
#############################################################.##################################################################
#############################################################.##################################################################
#############################################################.##################################################################
#############################################################.##################################################################
################################################################################################################################
################################################################################################################################
################################################################################################################################
################################################################################################################################
################################################################################################################################
################################################################################################################################
################################################################################################################################
################################################################################################################################
################################################################################################################################
################################################################################################################################
################################################################################################################################
################################################################################################################################
################################################################################################################################
################################################################################################################################
################################################################################################################################
################################################################################################################################
################################################################################################################################
################################################################################################################################
#####################################################################.............##############################################
################################################################################################################################
################################################################################################################################
################################################################################################################################
################################################################################################################################
################################################################################################################################
