################################################################################################################################
###..................................##############################################################...############..###..#######
###.##########################........#########################.######....###########.....######.......######..##.........######
###.#####...########..#######..........###############...#####.............#########.......#####.......#####................####
###.###........#####...#####...........##############....######............#########.......#####.......#####................####
###.............#####...###............###########......########...........#########......########......###.................####
##..............#####.................###########.......#########..........#####.###.....##########........................#####
##..............####..................##########.........##########......######...###.....########........................######
##...............##...................##..######..........#########.....#######...###....................................#######
##.........................................#####...........########.....######...#####...................................#######
##..........................................###.............#######......####....#####...................................#######
###.........................................###....######.....#####...............####............####...................##..###
###...............................................########.....####.................#............######.......................##
###...............................................#########...#####..............................######.......................##
###........................###...................#################................................#####.......................##
###.....................######.................##################.................................####........................##
##.....................######.................##################.................................####.........................##
##.....................#####..................###############.................................######..........................##
###..##.................###....................#############...........#.....................######..........................###
###.####............#...........................###..######............##....................######.........................####
###.####...........####.............................................................##.......######.........................####
###.####............####...........................................................###.......#######.........................###
###.#####............#####......##................................................####.......########..............###.......###
###.#######............####....####.................######........................####......##########...........######......###
###.########.............###..#####...............########................###......##.......###########.........######.......###
###.########...............########.........############.................#####..............###....####........######.........##
###...#######.#.............########.......############.................######.............###......##........######..........##
###....#########............########.......############.................######............####...............######...........##
###.....#######.............#########......####..######.................######...........####...............######............##
##.......#####..............#########.......##....#####.................######..........#####..............######.............##
##..........................#########...............##...................####..........###.................#####..............##
##..........................#########...................................................#...........###.....###...............##
###........................#########................................................................###......................###
###.....##................##########...............................................................####......................###
###....####...........#..############.............................................................#####......................###
###....#####.........#########....#######...............................##.......................######.......................##
##.....######........########......######.............................####.......................######...####................##
#......#######.......########.......#####............................####..........#######.......#####...######..............###
#......#######......########................#............##..........####.........#########.....####.....######..............###
##....#######.......#######................###..........###...........##...........###############......######..###.........####
##....####...........#####.................###.........####...#....................##############.......######..###.........####
##.....##..............###................###.........####...###...................###########.........######...............####
##.....................####...##..........###.........####...###....................#########.........####..................####
##.....................####...##.........####..........##............###.............########........####..................#####
##......................##.............######.......................#####.............#######.......####...................#####
##....................................########......................######.............######.......####....................####
#......................................#######.......................#####.............######.......####.....................###
#.......................................######........................###..............#####.........###......................##
#........................................####..................#...............#........###..........####......##.............##
#.........................................###.....##.......######.............###....................#####....####.....###...###
##........................................###....####.....######..............###.....................####....#####..###########
###..................##........##.........####...#####....#####...............###...............##....#####...##################
###....######.......####......###........#####....####.....##..........##....####..............############....#################
###...##########....####.....####......#######.....##..................###########...........##############....#################
##....###########....####..######.....########.........................###########...........#############......################
##.....##########......##########....########...........................#########............#############......################
##...........#####......#########....#######.............................##..###................#########.......########..######
##............#####..........#####..###..........................................................########.......######.....#####
###............######........#########.................###.......................................#######.........####.......####
###............#######.......########.................#######...............##..................#######..........###........####
###...........########.....#########..................#######............#########..............#######..........###........####
###.#........#########....#########...................#######............##########.....###......######..........####.......####
###.##.....###########...#########....................#####..............####....##....#####.........##...........###.......####
###.##....###########....#########..........#.........#####..............###..........######.......................##........###
###.#....#######..........###...#..........#######....#####..............###..........#####..................................###
###......######.............................#######...########...........####........#####......##...........................###
###.......####...............................#######...########.........#####.......#####......#######..##..................####
###.#.....####.................................#####....######......#########.......####.......###########..................####
###.###..#####...................................##................#########....########......############............##....####
###.##########...S................................................#######......##########....####....####............####....###
###.#########....................................................#######.......#################.................########.....##
###.########..........................##.........................#####..........###############.................#########.....##
###..................................###...................#....######...........##############..............E########........##
##..................................###...................###..#########..........#############........##....########.........##
##..................................###......##...........###############.........############........####..########..........##
##............................#.....###.....####...........##############..........##########..........############.......######
##..............####.........####..####.....########........#############............#####..............#######..........#######
#..............######.........#########......#######...........#########..............###.........##.....#####...........#######
#..............#######...........................###...............#####......................#######.....................######
##..............##..####......#########.............................####.....................#########......................####
##...................####.....#########.............................#####...................##########.......................###
##....................###....#########...............................####..................###########................####...###
##....................###.....##......................................##...................##########................######..###
##................##...###................................................................#####.......................#####..###
###...............##....###.............................###..............................######................##.....#####...##
###...............###...####..............##..........######............................#######...............####.....###....##
###...............###...####.............####.........######...........................#########..............####...........###
###...............###....##..............####.........######.........#.................#########..............###...........####
###...............###..........#........#####.........#####.........###...............##########...............#............####
###..............###..........###.......######........######..###..####...............#########..............................###
###.............####.........#####.....#######........################................#########......##......................###
###.#...........####........######....#######.........###############..................########......##.......................##
###.##...........###......#######.....######...........##############...##................######......##.......................#
###.###..........############.........#####................###########.###....###..........######.....##.......................#
###.####..........##########..........####..................#############....####...........#####..............................#
###.#####.........#########............###.............#......##########....###..............####.............................##
###...###..........######...............##............######......#####....###.......#.......####.............................##
##.....##................................##............######......###.....###......###......#####.....................##.....##
##.....###...............................###............#####...............##.....###.......#####....................####...###
##.....#####.............................###.............####......................##.......................##.......#####...###
###...#######...........................####..............##...............................................####......####...####
#######..####.........................######.........................................##..............#.....####.....#####...####
######....###........................########..........................##............###............###.....###.....####...#####
#####................................########.........................####............#............####.....####...###....######
####..................................#######.........................####......##................####.....##########....#######
####...............##.................######...........................###...######..............#####....##########....########
###...............####................######......###..................##############.........########.....####.........####..##
###...............####................#####......####..................########.######.......########....................##....#
###.....##.........####................##.......#####..................#######...#####.......#######..........................##
###....######......######.......................#####...................#######...###........######...........................##
###....#######.....#######......................#####...................########..............####............................##
##.....#######....########......................####....................#########..............................................#
##.......######..###...####....................####.....................#############..........................................#
##.........#########...#####...................####......................#############..............###........................#
##...........######...######...................####........................############.............####......................##
###...........#####...######......#............####................##.......############............#####.....###............###
####............####...####......###............###...............####.......############..##.......#####.....###............###
#####............###...###........#.............####..............####.......########..#######....########.....###............##
######.................###......................####...............##.........##........######....#.....###....####............#
######..................##.......................####...................................######...........###..######...........#
######...................##.............###........######....................##..........#####...........###########..........##
#####....................####..........#########.....#####................######.........####.............##########..........##
###................###....####.........##########......###...............########.........###.............#########...........##
##................####....#####.........##########.....####.............##########.........##............########......###....##
###...............####....#####..........##########....#####............###########........##...........########......#####...##
########....######.......######..........#######################........############......####...################..#############
###################..###########..####..#############################..################.########################################
################################################################################################################################
