################################################################################################################################
###########....#################....#####.#.#############################.#.####################################################
#########........######....###........#......########################.........##############.#######.......################..###
#######..........#####.........................#####################............#.########.....####.........##############....##
#######...........####.........................##########.#.######................#######....................###########......##
######.............###.........................######.........##...................#####.....................#########........##
#####..............####.............#...............................................####.....................########........###
####................###............###..............................................###....................#########.........###
###..................#............####..................................................................#.#########.........####
###...............................####.................###............................................#############.........####
###..............................####.................#####.........................................###############........#####
###..............................####.................####........................................##################.......#####
###..............................###..................####....................................######################........####
###..............................###...................#.................###................#############...#########........###
####.............................##.....................................####................###########.....#########........###
###...........................................................#..........###...............#############......#######.........##
###.........................................................#####...........................##########.......########.........##
###.................#...................###.................####...........................#######.#.........#######..........##
##...................#.#...............####................######..........................#######..........#######............#
##..................#######.............####...............######..........................#####............#######............#
##...................######.............####...............########................####.....####............######.............#
##....................####...............#####.....##.......#######................####......................######............#
##.........................................###.#.####.......########...............####......................#####............##
##.........................................#########.........#.#.##.................###.......................####........######
##...........................................#######.................................##........................#.....###########
##.............................................####...................................##............................############
##...............................................###......###.........................##.............................###########
####.......................................................######......................##.....................#.......#......###
####.......................................................#######......................#....................###..............##
####........................................................#######............##............................####.............##
###...........................................................####.............###..........................######.............#
##..............................................................#...............#..........................########...........##
#.......................................#.#.##.............................................#...............##########..........#
#.........##..........................#########............................................##.............###.########........##
#.........##.........................###########.......................................#######............###...##.#.#........##
###.#.#...#.........................###....####.........#.............................########............##...................#
######......................#..............####.........#####........................#########............##..................##
####...............#.......####..............#.......##.#######......................#########.................................#
##................##.......######...................##...######.........................######................................##
###...............###......########.....................#####...............##...........######................................#
##.................###.....##...###......................##................##............######...............................##
##..................###...........##...................###.................###...........######..............................###
##...................##...........##...................###................####............#####..............................###
##...................##...........####.................###.................###.............###...............................###
#.....#............................###..................##.................................###................##...............#
##...####.........................######.#...............#............................####.###...............###..............##
#....#####.........................###.#.##...........................................########...............###..............##
##...#######.............................###.....................#..................##########..............####.............###
##..#############........................###....................##..................#####.#.#...............###..............###
##...#############................................................................#####......................##..............###
####.###############........................S.....................................###.........................................##
####.#################..........................................................####...........................................#
####..##################.............................................###.......###............................................##
##.....##################.#.........................................####.......................................................#
##.....#########.################...................................###.......................................................##
#......#######.....###############.................................####.................................####...................#
##.....#######......#.......#.#.##..................................###................................#####..................##
#......######......................................................#####.......................................................#
###....####.........................................................####......................................................##
###...#####...........................................##...........#####.....................##................................#
#####.#####............................................#...........####......................####.............................##
###########......................................................####........................####.......###...................##
###########..........................####........................##...............#............####.....######...............###
###########.........................####.........................................###............###.......######..............##
######..####........................####...##....................................####.......................#####....#.......###
####.....##..........................##....##.....................................###.......................#####...###......###
####......................................####....................................###........................###.....###.....###
##.........................................###....................................###.......................####.....####..#####
###......................##...............#####...................................###........................##.......##########
##........................#................####..................................#####................................##########
###......................................#######.................................#####..................................#.######
##...................................#.#.#######.........###...................#######......................................####
###................................#############.........#####.................######.......................................####
##................................#############..........#.#####.......#.....########........................................###
###...............................###.#.###..................#####.#.###.....#######........................................####
##................................#.....###...................###########....######.........................................####
###......................................#......................########.......####........................####............#####
###....................................####.....................####.#.........###................#.###########............#####
##....................................####......................####.............###....#........#############.............#####
##...................................#####....###..............####.............##########......####.#.####................#####
#............#.......................######....##..............####..............#########......####......................######
#......##..####.....................#####......................####................#.###......####.........................#####
#.....#########......................###.###...................###..........................#.####...........................###
#.....########..................................................#...........................#####.............................##
#...#########.........................#####.................................................####..............................##
###.##########.........................###.........................................................................#...........#
###############......................###....................##.....................................................##.........##
#############........................#....................####......................................................#..........#
######.####.........................##....................####.....................#.#.###....................................##
####.#.####.........................##...........##.....######...................###########........####...............###.....#
###....###..........................##...........##.......###...........#........#####.#.###........###..............#####....##
##......##..........................###..........##...................####......#####....#####....#####.............#######...##
##.................................#.#..........###..................#####......####.......###.#.######............########.####
##.................................#.#...........##..................####.......###..........######.#..............#############
###........................................................###.................................#..................####....######
####............####........................................##....................................................##.......#####
#####..........######......................................###...................................................###........####
#####..........######.........#............................###..................................................###..........###
####...........#######.......###.......................................................#........................##............##
##...............#####.......###......................................................##........................##...........###
##.................###.......##...............................................................................................##
#....................#.......##.......#......................................................##.................E.............##
##...........................##......####....##............................................######..............................#
##.....#.....................##.....#####.....#............................................######..............................#
###....###...................##.....####......#............................................######..............................#
###....###...................##.....###.......................................................#................................#
##......######..............##.................................#...............................................................#
###.......#####..............................................###....................................#.#........................#
##..........#####...............................#...........####..................................#####........................#
###...........###..........................#...###..........####.................................######........................#
###......................................###....###........###...................................#####.........................#
####...................#.................#.....#####.......###..................................#####..........................#
#####................#####......................#####.....####...................................####.........................##
#####.##.............#####.....................######.....###.........#.........................####..........##.........#######
###...####..........#####.......................######..######........##........................####...........##........#######
###....####.........###........................######....####.................................#####...........###.........######
#........#..........#..........................#####....######................................#####............###........######
#..............................................#####......###................................######...........####.........#####
#..............................................####.......####.................................#.###...........##..........#####
#............................#.................####........##..................................................##............###
##..........................####.................#.........##................................................................###
##..........................######........................##..................................................................##
####.......................########.......................##..................................................................##
####........................#########...................####.....................#............................................##
##########................###############...............####....................####.........###..............................##
###########...##...#.#.#.##################...........#######.................######......########.#.........................###
###########.######.############################################.#.#.........#.########################.#........#.##.#.#.#######
################################################################################################################################
